党国 元老 张群 王世杰 及 罗家伦 夫人 	T
比利时 国防 大臣 就 指示 参谋部 着手 制订 撤军 的 各种 安排 	M
社会 上 纷纷 谣传 农村 家庭 承包制 和 企业 厂长 负责制 要 变 了 	M
把 对外 活动 搞 得 卓有成效 	M
经济 损失 仅 是 一个 方面 	M
上周 在 巴格达 会晤 伊拉克 总统 海珊 及 外长 阿济兹 的 苏联 特使 普利马可夫 透过 一 名 通译 说 	T
骗到 内湖区 大湖路 草丛 的 废矿寮 谈 事情 	T
如果 以后 再 有 机会 来 北京 	M
是不是 戏 中 有 戏 呢 	M
其中 福建省 的 三 个 市 就 占 ３２ 个 摊位 	M
味全龙 举办 此 次 活动 的 目的 乃 在 藉 各 项 节目 的 联欢 来 拉近 球迷 与 球员 之间 的 距离 	T
不能 让 其 占 半点 便宜 	M
也 可以 罚 他 按摩 搥背 捏 脚丫 	T
说 他 要 向 主席 报告 如今 的 好日子 	M
北约 这种 不安 的 心情 事出有因 	M
想必 现在 来到 北京 的 人 和 北京 市民 都会 黯然神伤 的 	M
可是 当晚 也 有 许多 系学会 办 舞会 	T
在 旧 衣服 堆 里头 脚 相 挨 地 躺 在 一起 	M
手 中 握 著 满 把 现金 	T
只 需 把 手头紧 一 紧 	M
除 破 全 国 记录 者 外 	T
加之 一 小 块 石灰石 调节 着 水 的 酸碱度 	M
１９９１ 年度 政府 预算 的 审议 	M
如果 我们 不能 看清 谁 才 是 与 中共 相 呼应 	T
为 制订 加强 家门口 兵 管理 的 正确 措施 	M
李 鹏 总理 在 七 届 全国 人大 三 次 会议 的 政府 工作 报告 中 提出 了 一 系列 方针 政策 和 措施 	M
市 交通局 副 局长 成 日晶 	M
但 不 包括 金融局 的 员额 	T
兰詹 被 安放 在 汽车 内 的 炸弹 炸 死 	M
我 感到 我们 的 老百姓 遭受 的 损失 太 大 了 	M
网球 表演赛 由 李 院长 和 彭旭明 先生 罗 副院长 伉俪 均 分别 下场 竞技 	T
欧洲 内部 的 经济 联合 便 越发 显得 紧迫 和 重要 	M
它 也 盼望 您 的 伫足 参观 	T
三十三 名 官员 及 五十 个 记者 	T
他们 就 听懂 了 大象 叔叔 说 的 话 	T
荣华 鸡 扑 翅 闯进 斗鸡 场 	M
最 怕 去 广州 火车站 买 票 	M
该 校 在 约 距 校舍 一 公里 处 试探 水位 	T
将 交通路 这 条 有 文化 传统 的 街道 恢复 重建 为 有 新 时代 特色 的 文化街 	M
一 句 话说 得 大家 都 开心 地 笑 了 起来 	M
如今 参加 联营 的 农民 有 ５５００ 多 户 ７５００ 个 劳力 	M
但是 绝大多数 经济学家 和 国会 预计 的 增长率 仅 为 百分之一点六 	M
演唱会 采 开放 点歌 的 方式 进行 	T
但 教育部 认为 辅大 传播 学院 目前 并 无 设立 的 条件 	T
往往 会 受到 时间 和 空间 的 限制 	T
但 由于 资金 严重 短缺 制约 着 勘探 	M
人们 的 情绪 旋 由 焦灼 转为 激动 和 欣喜 	M
警方 已 依据 遗留 的 证物 深入 追查 死者 身份 	T
也 就是 在 风险性 比较 小 的 地方 进行 勘探 	M
国内 最少 机会 进修 的 法文 歌曲 处理 正好 得到 解决 	T
是 他 背 我 过来 的 	M
现有 的 经济 指标 皆 显示 这 次 不景气 系 短期 性质 	T
皆 应 灌输 这些 观念 与 做法 	T
全年 的 累计 销售 总额 则 为 零 增长 和 负 增长 	M
讨论 了 对 南非 的 制裁 问题 	M
失去 在 国际 舞台 竞争 的 本钱 	T
人民 必然 会 走向 奢华 与 脱序 	T
而 分公司 的 开办 费 就 高 达 ２０００ 多 万 元 	M
指 人际 关系 中 通过 交流 而 创建 的 共识 公信 和 感情 	T
西宁 街头 一些 旨在 扩大 销售 方便 群众 的 商品 展销会 相继 出台 	M
自然 比 同 年龄 的 孩子 懂事 很多 	T
全国 现在 已 拥有 ３．２万 个 服装 企业 	M
难以 消除 三 党 之间 长期 的 门户之见 	M
将 两 阶段 实施 停开 措施 	T
并且 在 不断 扩充 军事 力量 	M
交易 双方 为 上海 海通 证券 公司 和 中国 信息 信托 投资 公司 	M
须 经过 每 年 十二月 及 六月 两 次 选秀会 才 能 加入 	T
从 他们 脸上 的 表情 可以 看出 	M
少女 吸安 竟 占 犯罪 总数 的 一半 	T
都 是 我 自己 的 钱 	M
打 过 仗 的 人 退出 了 政治 舞台 	M
就 创造 了 以 孩子 们 为 消费 主体 的 快餐 文化 	M
战争 不仅 是 综合国力 的 较量 	M
各 级 政府 行政 及 教育 事业 军火 工业 之 员工 不得 组织 工会 	T
这 将 使 美国 政府 更 难为 弥补 财政 赤字 筹集 资金 	M
个人 和 国家 利益 相 结合 局部 利益 和 整体 利益 相 结合 	M
但 它 仍然 是 治标 而 非 治本 的 方法 	T
接着 县上 乡 上 学校 都 在 操心 这 件 事 	M
由 香港 上海 汇丰 银行 有限 公司 	T
去 向 我 的 老师 告别 	M
我们 完全 遵照 与 美国 取得 协议 的 政策 行事 	T
猴祭 与 大 狩猎祭 是 卑南族 传统 的 祭典 	T
等于 国家 每年 用于 扩大 再生产 的 总 投资 	M
因为 我 所 看到 的 所 接触到 的 台湾 是 一 个 相当 奇怪 的 地方 	T
上海 荣 华楼 在 国内 首创 高压 气 炸 烹调 工艺 	M
反 腐败 斗争 要 关乎 社会主义 建设 和 改革 开放 的 大局 	M
见 一 位 老大娘 横 躺 在 地上 昏迷不醒 	M
两 人 就 从 半空 中 摔 了 下来 	T
教务处 的 人 也 没有 那么 多 时间 一一 帮 学生 查 成绩 	T
又 不 像 旅游 的 闹剧 了 	M
这 将 为 动荡 的 南朝鲜 政局 注入 新 的 不 稳定 因素 	M
但是 根源于 族群 语言 地域 性别 阶级 和 宗教 的 各 种 势力 	T
行政院 国家 科学 发展 委员会 已 将 所 补助 且 获得 专利 的 研究 成果 汇编成 工程 科技 生物 科技 自然 科学 等 三 册 	T
当初 会 有 全 语文 大 史诗 这 个 构想 	T
开始 积极 探索 体 教 结合 的 新 路子 	M
今天 的 人 确是 给 了 自己 太多 的 纵容 	T
在 人们 的 思想 上 形成 了 一些 习惯 认识 和 传统 观念 	M
考试 和 报告 何者 较 能 测出 学生 的 学习 效果 	T
各 陵 均 是 用 木俑 来 代替 人 殉葬 的 	T
其中 红 碎 茶 产量 居 全国 首 位 	M
建立 安全 体系 一 事 仍 止于 构想 阶段 	T
英国 舆论 强烈 反对 保守党政府 取消 制裁 的 决定 	M
协议 金额 更 只 有 七十九亿 美元 	T
只得 任凭 强势 传媒 将 多元 社会 的 优良 触媒 隔绝 或 稀释 淡化 	T
或许 会 受 不少 启发 呢 	M
记者 参观 访问 了 劫 后 的 科威特 大学 	M
金 文秀 和 朴 柱奉 获得 冠军 	M
在 联合国 主持 下 召开 一 次 或 多次 有关 解决 中东 问题 的 国际 会议 	M
难怪 有 人称 它 是 中国 第一 戏剧 大篷车 	M
并 指示 一定 要 组织 好 抗震救灾 工作 	M
东部 地区 为 石油 工业 的 发展 作出 了 巨大 贡献 	M
室内赛 对 所有 受 风速 影响 的 项目 	T
让 经销商 依 用户 的 需求 	T
本世纪 内 已 有 １／４ 感到 紧缺 	M
安和 证券 研究部 副理 张芳俊 表示 	T
亦 成 场 外 游客 目光 的 焦点 所在 	T
由于 目前 大盘 在 连拉 三 根 长黑 后 	T
重 短期 财务 绩效 追求 的 害处 明显 可 见 	T
主要 是 在 当前 这种 竞争 意识 下 所 采取 的 手段 	M
关系 著 台湾 石化 工业 和 钢铁 工业 未来 的 七轻 和 钢铁城 计划 	T
常 有 海内外 学者 指名 要 展看 	T
社会 经济 发展 徘徊 不 前 甚至 倒退 	M
以 表达 对 小 邢 阳 的 祝愿 	M
可以 一 窥 台湾 两百多 年 来 的 发展 历史 	T
有时 竟 和 别的 犯人 打 起来 	M
而 我 也 认为 这些 课 确实 有 其 存在 价值 	T
攀上 企业 发展 的 新 高度 	M
其实 普雷 并 不 需要 钱 	T
这 位 六十 年代 的 大学生 	M
都 来 读读 这 篇 文章 	M
何不 用 这些 精力 认真 去 办 点 事情 	M
一方面 给 我 三 叔父 拜年 	M
其余 的 人 挤 在 他 周围 	M
仅 花 了 卅七 分钟 即 击败 捷克 选手 艾布苏德瓦 	T
这 十二 件 钟 还 因 上铸 的 铭文 更 显出 价值 不凡 	T
你 必须 先 确认 究竟 员工 目前 的 基本 技能 程度 如何 想要 达成 的 水准 为 何 	T
对 不 该 投入 的 坚决 不 投 	M
立法 机构 应该 快 上 加快 	M
行业 主管 部门 和 物资 电力 运输 银行 等 部门 	M
必须 首先 准确 地 理解 它 	M
那 是 不 辨证 的 不 科学 的 	M
这 为 日本 参与 竞争 扩大 向 中国 出口 提供 了 机会 	M
第二 家荣 华 鸡 连锁店 也 已 开张 在即 	M
相信 应 可望 在 十二月 底 前 完成 系统 建置 	T
有 多 党 合作 和 政治 协商 制度 	M
不过 小组 人员 抵达 现场 时 	T
也 可 交换 对 一些 组织 内 问题 的 看法 	T
老乃 早 该 占 一 位置 喽 	M
未来 使用 者 购买 电脑 时 	T
时速 约 可 达 ７０ 公里 	T
杨 院士 由于 对 物理 科学 重大 而且 原创性 的 页献 	T
乡村 干部 冒 着 齐胸 深 的 洪水 把 我 救 出来 	M
这 所 学校 建成 的 同步 辐射 加速器 	M
所以 一 次 只 能 寻找 一 个 两 个 	T
这 也 是 为什么 杭廷顿 教授 竟 危言耸听 地 提出 	T
民进党籍 县议员 林丰喜 于 全 县 各 地 举行 的 问政 座谈会 中 	T
武警 公安 干警 正 协助 工程 人员 紧张 安装 爆破 装置 	M
此 从 我国 工会法 第二十六 条 	T
专 售 ６４ 次 车票 的 窗口 前 	M
我 得 马上 赶回 去 还有 任务 	M
我 买 我 要 的 东西 	T
每年 都 向 所在 区 社会 福利院 捐赠 １０００ 元 	M
即 学校 事务 由 最 高 的 行政 单位 来 决定 	T
这 是 一个 有 争议 的 预算 	M
修 护 路 大坝 １ 处 	M
镇 有关 部门 未 采取 得力 措施 予以 制止 	M
特别 是 南方 一些 经济 发达 省市 打 进 北京 的 	M
你 评 上三 里 级 售货员 后 经营 状况 有 没有 变化 	M
每 部 机组 每 天 可 生产 ３０万 加仑 的 纯水 喔 	T
庆贺 武汉 人民 战胜 了 一九五四年 的 洪水 	M
他 背 起 沉重 的 工具包 	M
燃 爆竹 养 狗 与 政令 	M
也 不会 有 今天 非洲 南部 在 政治 意识 型态 及 战略 上 的 权力 平衡 	T
结果 除了 两 位 外出 探亲 一 位 妻 生 重病 请假 外 	M
却 清楚 地 记下 了 老人 的 另 一 笔 遗产 	M
古巴 的 军队 多达 十四万五千 人 	T
首次 有 外籍 劳工 加入 游行 队伍 	T
若 不 是 中正 体育馆 的 一 场 比赛 租金 达 五十万 元 以上 	T
保持 人和 的 政治 关系面 是 应该 的 工作 行为 	T
故 应 学习 自我 抑制 的 耐力 	T
还有 相当 大 的 生产 潜力 	M
挟 北京 战役 大捷 之 勇 	M
像是 写 了 半 个 人 字 	T
一般 都 不 鼓励 明目张胆式 的 越级 报告 	T
欲 藉 高压 掩盖 内部 矛盾 	T
首先 应该 客观 分析 所 处 工作 环境 的 文化 特质 	T
也 是 在 前 几 届 省委 多年 研究 成果 的 基础 上 制定 的 	M
立即 调派 二 组 警网 分头 前往 查缉 	T
宛如 飘浮 在 金色 麦 海里 的 一个 个 绿 岛 	M
请 他 来 传 技 实 非 易 事 	M
肯定 了 办 特区 的 方针 是 正确 的 	M
要 更 好 地 发挥 毗邻 香港 的 优势 	M
每当 夏历 月初 月 中 涨潮 时 	M
今后 该 公司 将 凭借 著 专业 的 人力 资源 	T
便 能 了解 自己 在 班 中 的 水准 	T
赚钱 兼 做 学问 林汉章 不会 逢迎 不 懂 争取 的 个性 	T
如果 我们 这些 住 在 台湾 的 人 不 真心 关爱 本土 	T
首钢 的 经验 雄辩 地 说明 	M
这 也 符合 欧美 先进 国家 由 民间 推动 体育 的 潮流 	T
成功 关键 都 在于 使 员工 的 技巧 与 公司 的 需求 相 配合 	T
党 的 十二 届 三中全会 通过 的 中共中央 关于 经济 体制 改革 的 决定 指出 	M
张丰绪 昨天 很 坦然 的 说 	T
一个 具有 经济 科技 和 军事 潜力 的 强大 德国 重新 在 欧洲 中部 出现 	M
欧安 会议 签署 的 巴黎 宪章 	T
就 可能 尽早 发现 新 的 构造 和 圈 闭 	M
台湾 大学 课务组 日前 与 管理 学院 达成 共识 	T
讨论 主题 是 如何 提升 中研院 的 学术 水准 	T
老师 是 栽培 提拔 的 人 	T
达到 远 距 快速 运算 及 影像 传送 远 距 教学 等 功能 	T
精兵强将 优秀 人才 集中 在 生产 上 	M
因此 投资 金额 迟迟 无法 完全 执行 	T
这时 连队 正好 要 开展 战术 实 兵 实弹 演习 	M
向 麻袋 编织袋 或 筐 里 装 一块 块 叮叮 当当 的 东西 	M
企业 设备 生产 安全 情况 如何 	M
进一步 发展 各种 形式 的 对外贸易 	M
而 七十 岁 高龄 的 陈月里 不但 自己 是 画家 	T
从 副 市长 局长 到 司机 勤 杂 	M
学校 应 订定 一 套 优良 家庭 作业 奖励 办法 	T
并 没有 特此 作为 做 广告 搞 公关 的 好 机会 	M
既 维护 了 国家 的 主权 	M
有 山地 服务 经验 的 人 或是 幼稚园 的 老师 	T
但 要 实行 起来 就 得 借鉴 舍 孔雀 而 取 凤尾 的 取舍 观 	M
历经 全球 资讯业 市场 风浪 的 大起 大落 	T
而 由 办公室 人员 接 电话 	T
可以 看到 三 个 氏族 部落 分布 在 华东 及 华西 的 三 大 区域 	T
在 一 个 集 悲欢离合 于 一 地 的 地方 机场 	T
一个 胖胖 的 妇女 把 他 拉 起来 	M
而 假借 神明 名义 以 为 消极 的 抗议 	T
或 频宽 切割 给 大量 资料 传输 的 多媒体 或 图形 工作站 	T
朝野 政党 一致 喊 出 了 坚持 大米 自给 的 口号 	M
有 哪些 具体 的 做法 和 行动 	T
见 一 位 解放军 守 在 母亲 床 前 	M
尽管 各 成员国 至今 还 未 正式 表态 	M
战乱 间 两 度 流落 民间 	T
在 与 队员 们 合影 时 	M
国民 自 连续 跳空 涨停 数 日 抵达 元 以上 后 	T
很 难 有 人 能 出其右 	T
即使 你 不必 面对 这些 特殊 状况 	T
这个 法律 草案 在 没有 先例 借鉴 的 情况 下 	M
而 从 停火 到 大选 的 期限 则 应 在 以后 由 安 所有 政治 力量 共同 商定 	M
努力 提高 政府 职能 部门 工作 效率 	M
在 焦 裕禄 生前 坐 过 的 那 把 因 经常 顶 疼痛 的 肝部 而 磨 破 了 的 藤椅 前 	M
观察 是否 有 严重 问题 发生 	T
大楼 内 可能 会 设有 一 间 表演厅 	T
大桥 工程 局 的 每 一个 职工 也 深知 肩负 的 重担 	M
这 次 夏令营 吸引 了 国内 八十多 位 著名 声乐家 来 参与 	T
其实 应该 说是 人 和 政 通 	M
这些 工作 占去 了 他 泰半 时间 	T
绝对 是 纸 包 不 住 火 	T
他们 在 合并 与 实施 内阁制 方面 围绕 权力 分配 问题 的 斗争 	M
他们 跑 到 一个 并 不 抱 主 随 客 便 态度 的 开发区 落 了 脚 	M
要 接 小王 去 参加 外婆 的 ６０ 寿辰 	M
别人 几 次 要 替换 他 	M
并 在 实践 中 不断 地 加以 改进 和 完善 	M
一个 早就 被 否定 的 行为 如今 却 肆无忌惮 	M
据 曾 前往 品尝 此 道 女 学生 风味 的 人士 表示 	T
脚 臭 汗臭 口臭 加上 一些 食物 变 馊 发臭 	M
有人 上台 唱 起 了 女大 校歌 和 延水 谣 	M
实现 了 基本 自给 或 大部分 自给 	M
尤其 要 注意 尊重 职工 的 主人翁 地位 	M
有 赴 钢城 包头 煤海 乌达 回家 探亲 的 工人 	M
暴雨 过后 的 沈 家门 渔港 显得 格外 清新 美丽 	M
法律 上 的 重 行 轻 言 	M
但 车 上 鸡笼 翻覆 后 	T
将 是 对 海部 内阁 的 严峻 考验 	M
扩增 已 开发 新闻 资料库 的 功能 推动 时报 线上 广泛 使用 落实 技术 移转 	T
而且 学生 代表 大会 的 运作 	T
即 拟 购买 县府 规划 在 燕巢乡 的 大学城 土地 	T
电台 不 是 天天 在 人们 的 耳边 重复 	M
企业 的 活力 才能 得到 充分 的 发挥 	M
约 有 六成五 的 企业 经理人 预期 经济 不景气 现象 将 持续 走下坡 	T
经济特区 要 在 建立 社会主义 市场经济 体制 方面 积累 经验 	M
如果 同学 不 想 花钱 使用 有 锁 的 柜子 	T
它 是 由 数十 位 国际 语言 专家 	T
满载 土鸡 从 吴厝 往 西螺 方向 行驶 	T
记者 李琢 台北 报导 北京 申办 二千年 奥运 的 最 大 对手 雪梨市 	T
把 主要 攻击 矛头 指向 中国 	M
其 波长 可 从 可见光 近 红外线 热 长 红外线 	T
进行 中 的 台史所 台湾 史籍 自动化 作业 	T
他 所在 的 连队 也 一直 被 集团军 树 为 基层 建设 标兵 连 和 军区 基层 建设 先进 单位 	M
如果 近 二 天 再 收红 	T
但是 面对 这样 一 个 新兴 产业 	T
结婚 才 四 个 月 他 就 开始 晚 归 	T
在 改革 开放 的 舞台 上 演出 更加 有声有色 的 活剧 来 	M
考 不 上 日大 的 考生 多 再 报考 夜大 	T
巴库 以及 整个 阿塞拜疆 和 亚美尼亚 两 个 共和国 的 局势 已 基本 得到 控制 	M
压抑 国内 民气 的 弱肉强食 态势 	T
这 的确 是 对 每个 国家 的 政府 和 人民 所 提出 的 一个 十分 尖锐 的 问题 	M
每 个 人 都 可以 提供 自己 的 知识 给 别人 	T
台中市 警二分局 逮获 持 枪 恐吓 	T
种族主义 不仅 是 南非 国内 动荡 不 宁 的 根源 	M
至于 为何 推出 以 史诗 为主 的 小说 	T
自 新年 以来 悄悄地 弥漫 在 日本 列岛 的 竞选 空气 陡然 升温 	M
你 得 老 防 背后 的 暗箭 	M
是 得到 全国 人民 的 支持 和 拥护 的 	M
而 因为 它 是 一 项 特殊 的 土木 工程 	T
中国 医科 大学 附属 二 院 三 院 	M
杨丽花 将 首度 尝试 摆脱 电视 的 束缚 	T
小西园 是 台湾 现存 最 具 传统 表演 型态 的 职业 布袋 戏团 	T
泰雅族 并且 有 喝 交杯酒 的 习俗 	T
持 枪 强 押 宋 教官 夫妇 谈判 	T
责怪 群魔 为何 从前 未曾 要求 总统 蒋 总统 们 出席 	T
要 比较 国内外 的 废纸 品质 	T
其 反弹 幅度 高达 一 倍 的 水准 	T
成为 我国 迈向 国际 先进 水准 的 洗衣机 之一 	M
只不过 有 人 在 核心 有 人 在 边缘 的 区分 罢了 	T
而 要 扎扎实实 地 学习 雷 锋 精神 	M
多极化 是 对 两极 格局 的 否定 	M
这 第一 次 我 激动 的 时刻 是 在 １９５５年 	M
依 公务员法 第二十四 条 第十 条 第十一 条 及 劳动 基准 法 第八十四 条 之 规定 意旨 	T
深圳 过去 取得 的 一切 成就 	M
雾峰 乡公所 函文 草屯 镇公所 速解决 乌溪 畔 临时 垃圾场 问题 	T
并且 用 朴实 沉厚 的 技法 认真 地 创造出 艺术 上 的 形像 	T
不可 擅自 在 丛林 间 任意 驰骋 	T
算起来 有 将近 一千 年 的 收藏 历史 	T
对 中国 政府 乃至 中国 领导人 进行 无端 攻击 	M
１３０ 多 家 服装 研究所 如 雨后春笋 	M
这 场 海湾 战争 使 中东地区 各国 对 美国 的 疑虑 有增无减 	M
郝 院长 在 终点 国父 纪念馆 发表 感言 	T
亦 为 其 在 亚运 归来 请辞 主席 职位 获 慰留 后 首 次 参与 的 国际 体育 事务 	T
按 月 拿 工资 补贴 岂 不成 了 公开 的 贪污 	M
大多数 病人 都 在 症候 发生 才 觉察到 疾病 的 存在 	T
可 这 件 小 玩艺 儿 一 加 	M
视为 都市 产业 振兴 的 重点 工作 	T
在 他 的 生活 中 除了 书 就 是 古董 收藏 	T
他 捡 了 块 碎 玻璃 	M
为什么 说 改革 也 是 一 场 革命 呢 	M
仅仅 是 为了 排队 买 一 张 进入 书市 的 门票 	M
无 往 网 不利 的 网路 新 时代 已经 来临 	T
办 起 正事 来 是 既 冷静 又 果断 	T
主办 这 次 比赛 可 帮助 词创社 成长 	T
而且 在 学校 的 时间 不 似 教授 那么 久 	T
一 是 两 袋 ８３ ６ 棉花 良种 	M
眼里 透出 了 幸福 的 泪花 	M
用 之 于 长远 的 改革 顺利 进行 	M
必 能 训练 学生 的 政治 思考力 	T
在 他们 不 愿意 的 时候 	T
部分 纸厂 会 以 库存 空间 有限 为 理由 停收 废纸 或 趁机 多 扣 一些 重量 	T
豆娘 则 比较 常 出现 在 溪流 上游 的 森林 边缘 	T
矿长 向 江 总书记 介绍 矿 里 生产 一线 的 工人 技术 人员 	M
到 尼加拉瓜 莫三鼻克 叙利亚 赤道几内亚 坦尚尼亚 北韩 阿尔及利亚 乌干达 寮国 阿富汗 狮子山国 等等 	T
海湾 合作 理事会 秘书长 比萨瑞 指出 	T
来到 了 我国 著名 的 小商品 的 河流 	M
既 不能 限制 地方 势力 的 抬头 	T
超过 了 当时 县政府 规定 的 每户 １２０ 平方米 的 限额 	M
目前 的 工作 是 和 各 社团长 沟通 以便 能 提出 一 个 大部份 社团 都 能 接受 的 方案 	T
中午 再 前往 加入 游行 队伍 	T
他 并 不 是 和 投资方 共同 开发 技术 	M
我 小 的 时候 和 父母 感情 不好 	M
许多 辽宁 人 尚 不 知道 悲哀 	M
连续 达 十五 年 的 战事 	T
离开 美国 而 谈论 为 建立 世界 新 秩序 作 贡献 仅 是 一 句 空话 而已 	M
我 忽然 想 把 他 的 这 番 话 告诉 他 的 父母 	M
却 遭 县议会 指摘 校舍 是 超级 大 违建 	T
他 叫 适之 先生 睡午觉 也 要 那 条 单被 答上 点 	T
其 落后 之 处 就是 散 倒 散装 	M
但 碍于 经费 不足 而 无法 实现 	T
统一 或者 地名 中国 中华 南洋 等 	T
顶多 是 皮肤 过敏 而 发痒 	T
四 企业 要 继续 在 调整 产品 结构 上 下功夫 	M
也 是 整个 南部 非洲 地区 动荡 不 宁 的 根源 	M
如 神经衰弱 神经 官能症 恐惧症 焦虑 症 多疑 症 等 也 有 疗效 	M
每户 用地 的 最高 限额 是 ８０ 平方米 	M
但 这个 说 资金 不 落实 	M
有 公车 自行车 摩托车 三轮车 马达 动力车 等 	T
他 连续 跑 了 三 个 乡镇 	M
有 一万五千 元 到 两万 元 美金 的 预算 	T
杨希 台风 已 由 轻度 转为 中度 台风 	T
当时 的 新科 举人 进士 称 考场 主考官 为 老师 	T
直至 市 城 监 三 中队 来 调查 时 	M
法国 同 美国 处理 这 一 危机 的 立场 并 不 完全 一致 	M
而 沸沸扬扬 的 议论 则 更为 炽烈 了 	M
引起 了 阿拉伯 世界 的 广泛 关注 和 深切 忧虑 	M
张丰绪 计划 从 菲律宾 返回 后 	T
后室 是 玄宫 中 最 大 的 一 室 	T
说起 这些 课程 对 学员 的 影响 	T
是 我国 目前 最 先进 的 洗衣机 生产线 之一 	M
在 社会 上 立足 的 角色 会 出现 问题 	T
由于 公立 大学 财务 自主 已 渐 成 趋势 	T
有关 方面 应 客观 超然 协调 人选 	T
还 能 把 媳妇 气 跑 了 	M
治疗 外伤 性 截瘫 有 新法 	M
不 是 台湾 或 美国 的 商标法 	T
几 位 省 市 负责人 和 其他 迎候 的 人们 	M
专 收 日据 时代 教育类 旧书 的 城户康成 	T
其 排放出 的 冷却 水 与 经过 炉心 的 水 是 分离 的 	T
台塑 六轻 欲 重返 利泽 工业区 	T
撇开 国际 艺术 拍卖 公司 设 栈 问题 	T
慈济 通识 教育 课程 设计 旨在 扩展 学生 对 知识 的 接触面 	T
顾客 从 商店 买 回 的 东西 遭到 损坏 	M
北京 市民 也 有 个 承受力 问题 	M
由于 查获 吸食 者 人数 骤增 	T
眼前 利益 相 长远 利益 相 结合 	M
在 台湾 的 生活 是 尽情 工作 尽情 作乐 	T
以 纾解 水林乡 历年来 严重 水荒 	T
主要 对象 是 己嫔 和 宫女 	T
几乎 都 有 三 项 标准 乐观 的 答案 	T
中国 是 一个 有 着 １１亿 人口 的 发展中国家 	M
战士 马 少波 刚 到 连队 那 阵 	M
至于 与 爱死病 患者 相 吻 过 	T
奈何 提出 建议 都 无 下文 	T
下周 还 将 接待 残 病人 专场 	M
苏威宇 与 赛门 五 比 七 六 比 三 七 比 五 胜 陈威儒 蔡文程 	T
晚餐 后 在 海边 举行 惜别 检讨会 	T
对 其 产品 能 否定 上 市场 变为 商品 却 不 甚 关心 	M
这 几 个 月 到 这 推销 产品 的 外地 厂家 哪 天 都 不 下 二三百 人 	M
他 呼吁 阿拉伯 各国 反对 这 一 阴谋 	M
早已 成为 各国 认可 的 国际 惯例 	M
刘 等 三 人 于 今年 十月 廿七日 下午 二时 	T
复杂 的 南非 问题 才 有 希望 获得 解决 	M
这些 特征 包括 更 好 的 毛皮 品质 和 色泽 	T
二 后 的 神座 雕 凤头 	T
原油 价格 今天 下降 了 超过 七十分 	T
如果 这 种 设备 能 便利 住宿生 并 保障 他们 的 安全 	T
晚上 睡 在 地下 道 里 	M
以 团队 方式 作业 的 企业 所 培训出 的 管理 者 	T
势必 遇到 民间 工商 企业家 竞选 的 考验 	T
宏碁 将 可 藉 此 发展 隐藏式 控制器 	T
并 连任 两 届 龙泉 县政协 常委 	M
并且 把 统一 后 的 德国 栓 在 欧共体 的 车队 里 	M
并 不 像 报纸 所 载 是 没没无闻 的 公司 	T
多少 也 能 赚 回 点 钱 吧 	M
农民 们 已 开始 追求 高档 消费品 	M
衣袋 里 装 着 各种 药片 	M
在 贯彻 落实 环境 保护 的 方针 政策 和 法规 上 	M
公司 饶 总经理 兴奋 地 说 	M
用 蚂蚁 啃 骨头 的 拼劲 去 攻克 难关 	M
不料 楼梯 口 有 两 人 把守 	M
战士 们 连续 战斗 二三十 个 小时 	M
显然 已 将 战争 的 残酷 本质 掩盖 	T
四川 上百 家 的 老 企业 采用 计算机 数显 数控 技术 后 	M
而且 萨达姆 候 赛 因 最 精锐 的 卫队 也 已经 被 全部 消灭 	M
台安 医院 将 在 九月 五日 上午 举行 反毒 拒 烟 迷你 马拉松 慢跑 活动 	T
终 致 群魔 乱 舞 的 撒 豆 成 兵 后遗症 罢了 	T
２ ＋４ 会议 的 诞生 和 消失 	M
我 选手 获 尤尼克斯 羽 球赛 女单 前 三 名 	M
警方 每 天 查获 的 成效 	T
爬 向 老太太 卷起 裤脚 裸露 在 外 的 小腿 一一 想 靠近 火堆 取暖 	M
人们 惊异 地 看 着 车 前 挂 着 的 两 张 黄牌 	M
七月 二日 三日 的 正式 成所 庆典 学术 讲演会 及 参观 研究 成果 是 一 桩 大 喜事 	T
收费站 成 了 贪污 的 窝 子 	M
但 我国 的 经济 仍 处于 投入 多 产出 少 消耗 高 效益 低 的 粗放型 发展 阶段 	M
以色列 总理 沙米尔 也 公开 宣布 	M
深圳 也 初步 显示 出 具有 一定 经济 规模 	M
反 腐败 斗争 要 牢牢 把握 几 项 原则 	M
慰问信 慰问电 从 祖国 各地 雪片 似的 飞 到 青海 高原 	M
但是 每 舒卷 曝光 一 次 	T
新 预算 的 防务 开支 为 ３０３３亿 美元 	M
原因 是 波本 威士忌 只 有 美 	T
经过 一 番 角逐 较劲 之后 	T
将 于 院 内 公众 资料库 中 开放 各界 使用 	T
找 出 它们 之间 恰当 的 结合 方式 	M
早 在 去年 十二月 旅日 球员 选秀会 中 	T
买 咸菜 的 还 不见 少 	M
他 将 在 台大 活动 中心 进行 一 场 演讲 	T
累计 增产 水果 ３２万 多 吨 	M
挺举 第一 次 举起 一百五十 公斤 后 	T
要 根据 他们 各自 的 情况 	M
尤其 是 群众 已 呼吁 了 四 年 仍 充耳不闻 	M
金融 管理 的 组织 与 编制 有 配合 调整 的 迫切 需要 	T
呈现 的 却 是 产品 过剩 状态 	M
不知 是否 旧 戏 看 得 多 了 	M
自 九月 一日 起 该 品牌 化妆品 将 全面 在 盒套 上 加贴 一 个 商标 图样 	T
是 对 人民 群众 进行 社会主义 思想 教育 的 需要 	M
造成 了 资金 的 过量 沉淀 	M
救援 工作 一 分钟 也 没有 迟疑 	M
周围 的 群众 没有 一个 说 得 上来 	M
密特朗 是 在 意大利 总统 访 法 前夕 接受 意大利 电视台 记者 采访 的 	M
在 有限 的 经费 及 人事 与 其他 各 国 在 韩 所 作 推广 活动 频繁 及 花费 大 笔 财力 	T
在 保护 全球 环境 的 事业 中 	M
沉睡 在 壁画 上 活跃 在 民间 节日 里 的 西藏 民族 体育 	M
以及 我们 党 在 社会主义 建设 中 积累 的 丰富 经验 	M
会 在 未来 这 场 情报 战 中 处于 不利 地位 	M
挤 到 前面 的 刚 在 暗自 庆幸 	M
在 训练 期间 暂时 以 餐厅 为 训练 中心 	T
控制 到 新 的 后备 储量 	M
南朝鲜 人民 的 反 美 情绪 高涨 	M
从 巍峨 的 石 坝 脚下 乖乖 地 折 向 东北 	M
我们 看到 不少 来自 四川 江苏 等 地 的 妇女 	M
在 企业 农村 街道 学校 部队 机关 又 各 有 适合 自己 特点 的 发扬 民主 的 制度 	M
于 今年 二月 三日 上午 七时 许 	T
接受 采访 的 袜 厂 职工 直爽 痛快 	M
这 叫 平声 仄读 仄声 平读 	T
或 因 愚笨 的 差池 造成 恨事 等 	T
昨天 被 大会 列为 种子 球员 的 国际 著名 网坛 名将 	T
便 和 矿工 们 聊 开 了 	M
是 北京 航空 航天 大学 学生 敬献 的 花篮 	M
一 个 团体 获颁 前场 后场 及 团体 三 座 薪传奖 	T
造成 对 成绩 的 评定 不 够 客观 公平 	T
全面 调整 各 线 行车 班次 	T
安 政府 与 安盟 之间 的 和谈 是 在 葡萄牙 政府 的 调解 下 于 去年 ５月 在 里斯本 开始 的 	M
我 建议 应该 先 在 校园 中 由 学生 选出 几 个 人选 	T
尤其 是 近日 来 更 有 变本加厉 的 情形 	T
并 将 回溯期 由 一 年 缩短为 半 年 	T
一头 扎 进 连绵 的 群山 	M
还是 使 其 廉洁 的 形象 受到 损害 	M
李 永波 和 田 秉毅 获 亚军 	M
这次 发展 个 国家 环境 与 发展 部长级 会议 	M
今后 日本 对 中国 的 市场 将 更为 重视 	M
但 县府 水利课 深入 调查 结果 解释 说 	T
有些 版面 才 ２０００ 多 字 	M
抱 着 试 一 试 的 心理 向 厂家 写信 求援 	M
说 这 两 家 公司 背后 做 了 什么 动作 	M
台塑 六轻 此 番 再 战 宜兰 反 六轻 力量 	T
反对 种族 隔离 和 反对 使用 兴奋剂 的 坚定 立场 	M
是 想 多 认识 些 同 族 的 朋友 	T
日本 希望 通过 对 世界 新 秩序 形成 作出 贡献 而 成为 政治 大国 	M
三 位 歌手 以 出嫁 这 首 歌 揭开 序幕 	T
任由 民调 机构 藉 势 造势 	T
除了 刚好 国家 庆典 特别 多 	T
而 淡忘 的 又 岂止 是 这 一 名称 	M
我们 开发 了 ６０ 多 个 款式 规格 	M
可惜 他们 对 善后 的 处理 常 是 无能为力 	T
长虹 现象 来自 国营 长虹 机器 厂 的 报道 之一 	M
集团军 王 军长 在 二 连 倾听 战士 们 的 反映 	M
源起 于 娼妓 问题 严重 的 泰国 	T
看做 近世 史学 的 第五 大 发现 	T
１９８８年 以来 市 电影 公司 将 整理 出 的 配合 中学 教学 有关 影片 参照 表 发放 到 各县 区 教育局 及 全市 各 中学 教务处 	M
建 一 幢 办公楼 也 不 成问题 	M
一 群 楼 中 的 小 公园 	M
让 人 看 了 题目 不知 是 怎么 回 事 	M
财政部 编制 总员额 调整 将 由 原 二百四十二 人 至 三百二十五 人 	T
你 真的 是 个 好 孩子 	T
我们 坐 着 汽艇 登上 了 施工 中 的 ９ 号 桥墩 	M
仅 以 ２０００ 张 即 跳空 涨停 	T
９０ 年代 将 实现 再 翻 一番 的 目标 	M
预计 第四 季 即可 有 获利 回馈 	T
他们 正 以 兴奋 而 激动 的 心情 等待 着 	M
孙 保所 还是 没有 说 出 什么 来 	M
尤其 是 在 国内 采取 了 一 系列 松动 措施 	M
为 美国 历史 最 久 的 学术 团体 	T
现在 进口 的 多 是 农业 生产资料 	M
椅身 老旧 且 空间 太 小 	T
河南省 顾 委 副 主任 张 赤侠 代表 省委 省政府 把 一个 素洁 的 花环 置放 在 山头 的 纪念 亭 前 	M
自民党 为了 缩小 利 案 的 影响 	M
追 不 出来 就 告 邮局 是 共犯 	T
布希 总统 廿二日 突然 在 波斯湾 战事 出现 和平 转机 时 	T
普雷 开发出 全 世界 第一 部 掌上型 扫瞄器 	T
趁 年轻 到 地方 找 一个 好 位置 	M
目的 是 为了 在 １９９３年 １月 １日 欧共体 统一 大 市场 建成 之 日 	M
在 热 胀 冷 缩 的 原理 下 	T
去年 才 以 妈祖 系列 独霸 晚间 七点档 的 制作人 罗文忠 	T
奋战 在 多种 经营 战线 的 同志 们 更 要 振奋 精神 	M
市场 疲软 的 主要 方面 是 企业 缺少 资金 	M
那里 肯定 会 有 开水 供应 的 	M
领 桃 的 人 回到 会议室 继续 听 汇报 	M
销售 如 首饰 艺品 滤水器 儿童 录音带 等 街坊 便利商店 不 卖 的 东西 	T
基本 落实 了 １９９０年 的 生产 任务 	M
过度 性 复杂性 和 多 变性 	M
观光 潜力 雄厚 的 旅游 市场 	T
藏 传 法器 和 满族 服饰 	T
而 除了 该 工业区 十 用地 获得 变更 外 	T
但 黄国章 应 不致于 为 此 遭 人 持 枪 狙击 	T
荷兰 和 意大利 等 国 认为 	M
可能 会 考虑 出 张 唱片 	T
中国 人民 的 伟大 领袖 毛 泽东 同志 	M
中国 近 几 年 来 大幅度 减少 进口 是 治理 整顿 的 需要 	M
老太太 指 着 一个 人 说 	M
但 对 民主德国 部分 要 实行 改造 	M
左列 各 种 公务员 人事 法令 进用 或 管理 人员 	T
纯粹 只 当 它 是 一 项 新鲜 的 游戏 	T
另外 目前 竹东 保龄球馆 与 中联社 承租 的 工业区 用地 	T
不 知道 偷倒 垃圾 一 事 会 祸及 挖土机 工人 	T
近期 反 六轻 积极 人士 在 宜兰 地区 举办 小型 演讲 宣传 活动 	T
由于 近年来 事态 的 迅速 演变 	M
整洁 的 站台 修 了 花坛 	M
证明 该 工人 是 受雇 于 镇公所 	T
大多数 地区 仍 处于 农业 社会 的 生活 	T
偏偏 许多 人 都 有 这 种 不良 嗜好 	T
当 服务生 问 我 要不要 尝尝 瑞士 乳酪 	T
据 中华民国 交通部 观光局 汉城 事务所 所长 萧伯雄 表示 	T
当 大盘 于 全面 看涨 的 雀跃 中 	T
继 第一 阶段 台湾 方志 自动化 输入 完成 后 	T
线型 上 出现 一 缩 脚 之后 即 跳空 	T
维修 人员 白 跑 了 一 趟 	M
造成 居民 消费 结构 极 不 合理 	M
特 举办 此 一 意义 非凡 的 比赛 	T
我们 可 称 之 为 农民 美学 	T
斗六市人 及 另外 四 名 嫌犯 	T
在场 官兵 的 眼眶 也 湿润 了 	M
但 基于 地方 派系 主导 而 遭到 极 大 阻力 	T
对于 究竟 应 以 何方 的 时钟 为 准 	T
自 海湾 战争 于 上月 ２８日 结束 以来 	M
以 签订 技术 开发 合同 的 形式 	M
中部 将 由 原来 的 十四万 人 	T
屏幕 上 立即 显示 出 记者 本人 的 资料 和 尊容 	M
强壮灵 治疗 小儿 厌食 有 显著 效果 	M
而 每 年 春节 期间 水泥 的 销售量 只 有 七成 	T
全体 党员 和 各级 干部 必须 继续 发扬 开荒 牛 的 精神 	M
我 不 认为 进入 工作 职场 后 	T
明智 的 企业 对 金融 资本 与 人力 资本 的 理念 大有 差异 	T
目前 我们 仍然 没有 很 系统 的 方法 来 觉察 这 个 疾病 的 发生 	T
资深 立委 是 依法 行使 职权 	T
所以 和 全部 公布 并 无 差别 	T
遂 献计 炀帝 命 李渊 在 二 个 月 内 建造 一 座 晋阳宫 以 做 行宫 	T
一 家 进口 服饰 代理 业者 表示 	T
但 由于 受 宪法 和 日本 广大 国民 反对 等 因素 的 制约 	M
书画处 选出 三 组 各 二十 幅 名品 	T
于是 大家 都 不理 白 线 了 	M
本报 同仁 一如既往 支持 他们 的 工作 	M
并 对 部分 政治 人物 仅 著眼 于 权力 	T
国科会 已 将 这 批 研究 成果 整理 编为 工程 科技 生物 科技 自然 科学 三 册 	T
在场 的 省 市 负责 同志 聚精会神 地 聆听 他 老人家 的 谈话 	M
是 因 当时 气候 及 宫廷 中 的 一些 纷争 	T
还 规定 在 动工 前 到 镇 国土 所 和 镇 建委 办理 有关 手续 	M
牛皮 车座 上 打 着 两 块 补丁 也 张 着 口 	M
产能 可以 提高 两 到 三 倍 	T
不 上 长城 非 好汉 嘛 	T
今后 它 也 会 使 这种 友谊 更加 巩固 	M
她 是 不 想 让 远在 边疆 的 丈夫 为 她 母女 分心 	M
小 脸 因 激动 而 微微 发红 	M
就 给 他 很 少 的 零钱 	M
才 能 应付 因 高速 行驶 产生 的 膨胀 及 高热 	T
国际 油价 也 跌至 近期 低点 	T
荫庇 过 他们 爷爷 的 爷爷 	M
为 自己 上台 执政 做 准备 	M
听到 的 是 一连串 的 赞扬 	M
称赞 球场 旧 九 洞 的 风景 实在 宜人 	T
另 一 射手 蔡福财 亦 拿下 十八 分 	T
柯尔 将 大部分 的 基础 课程 安排 在 上班 时间 内 	T
有时 又 希望 日子 过 得 平静 安祥 	T
猛烈 攻击 了 美国 及其 所有 参战 的 盟国 	M
学校 从 八十学年度 指定 学生 必 修 的 人生 哲学 	T
是 全国 先进 党支部 所在 的 车站 	M
家庭 消费 型态 渐 呈 两极化 发展 	T
讨论 美国 从 南朝鲜 撤走 驻军 和 核武器 问题 	M
言谈 间 可以 感受 他 掌风 的 威力 	T
而 令 她 不悦 的 种种 情绪 	T
冷轧 薄板 成为 紧俏 中 的 紧俏 产品 了 	M
被 发现 的 十四 瓶 爆裂物 	T
这种 认识 显然 是 不 正确 的 	M
苏 宁 感激 战友 的 关怀 	M
一般 人 都 认为 ＧＭＰ 工厂 一定 要 很 大 的 投资 	T
是 为 加强 中 苏 睦邻友好 而 迈出 的 又 一 大步 	M
一 把 抱 住 杨 学宗 	M
并 办理 了 抵押 公证 和 登记 手续 	M
该 商标 及 所 代表 的 商誉 拱手让人 	T
使 顶端 的 小 球 膨胀 	M
记者 跟 厂 领导 中层 干部 一般 职工 谈到 这个 问题 	M
快 把 鲜花 给 妈妈 呀 	M
当 两 个 效益 发生 矛盾 的 时候 	M
工会 如 依 法 决议 罢工 	T
无论是 美国 提倡 军备 控制 	M
这 条 穿过 中国 首都 市中心 的 著名 大街 	M
李 放 就 受到 雷 锋 王 铁人 焦 裕禄 等 英雄 事迹 的 深刻 教育 	M
让 资深 主管 成为 他们 的 师父 	T
这个 问题 已 严峻 地 摆 在 了 我们 面前 	M
据说 过去 在 大家乐 风靡 时 	T
他们 做 得 太 过分 了 	M
辟 蹊径 是 要 在 市场 开发 上 争 个 头彩 	M
其实 也 蕴含 了 不同 种族 的 交流 激荡 	T
会 尽量 将 同 一 档案 的 资料 记录 在 同 一 个 磁柱 上 	T
她 略 呈 倦意 的 脸上 今天 挂 满 了 笑容 	M
并 将 新 书 目录 置于 网路 上 	T
那些 把 本来 属于 自己 职责 范围 的 正常 工作 当成 所谓 创收 手段 	M
决不会 屈服 于 美国 的 压力 	M
它 为 实务 经验 丰富 的 资深 管理 者 包括 最 高 主管 在 内 	T
再 进一步 在 全 国 科技 会议 或 类似 大型 科技 会议 中 提出 讨论 	T
其 间 我们 花 了 不少 心血 	T
改进 一下 垃圾车 的 工作 作风 和 款式 	M
此 第三 次 投标 却 让 首度 入场 厂商 得标 	T
不论 团主 许王 先生 本身 的 掌 中 技艺 或 后场 乐师 的 阵容 	T
添注 一 股 强而有力 的 贡献 	T
今朝 晓得 你们 要 来 检查 	M
昨天 同意 让 德军 空运 德国 萨克森省 人民 捐献 的 食品 至 苏联 	T
固定 基础 浇置 后 （２） 浮动 基础 浇置 前 中 后 （３） 固定 致动器 之 钢板 安置 等 	T
普雷 希望 定位 自己 为 宾士级 的 产品 	T
在 对 市场 作 必要 的 了解 之前 	M
一 名 矿工 大声 地 说 	M
长江 大堤 的 武昌 八铺街 东西 湖 围堤 武惠堤 古家头 等 险工 险段 	M
会议 产生 的 政治 和 经济 成果 	M
一座座 桥墩 的 翅膀 都 飞 起来 了 	M
对于 两岸 是 分离 ４０ 年 之后 	M
只要 精细 处理 和 充分 利用 已 有的 勘探 资料 	M
自然 挑起 公仆 的 潜在 争取 意识 	T
期望 它们 了解 在 巴拿马 发生 的 事 是 特殊 情况 	M
渤油公司 内 的 各种 议论 已 沸沸扬扬 	M
这 在 人口 统计 上 是 正常 的 情形 	T
经营 贸易 生意 的 林国 前天 下午 	T
用 海水 淡化 来 作为 未来 水源 的 开发 	T
黄牌 是 压力 也 是 动力 	M
目前 短片 的 映出 场次 已 占 全市 每年 映出 总 场次 的 百分之三十五 以上 	M
目前 公司 在 北京 的 维修 中心 就 有 ４ 个 	M
在 反省 号 的 一 间 办公室 里 	M
就是 到 了 现在 有些 环节 还 没 落实 	M
把 女性 的 生殖 功能 和 性 功能 列入 诊断 截瘫 的 临床 客观 指数 	M
但 却 无 传统 ＰＳ版 印刷 版材 	T
当 我们 拿 起 理性 的 放大镜 	M
但 昨天 冲过 二万一千 点 关卡 	T
但是 一 接触 到 实际 问题 	M
 谨 以 此文 参加 理 思路 抓 落实 奔 小康 大 讨论 	M
这 本 白皮书 对于 学生 的 部份 太过 简略 	T
竟 有 ５ 位 作 了 类似 的 反省 	M
因 专门 的 工具 书店 在 我市 从未 有 过 	M
进而 直接 影响 海部 内阁 的 命运 	M
将来 学生 活动中心 会 迁至 此 地 	T
该 公司 强调 磁带机 可以 说 是 目前 备份 设备 中 成本 效益 比 最 高 的 设备 之 一 	T
香港 和 苏联 两 队 将 争夺 第三 名 	M
使 我们 不易 分心 且 无须 死背 	T
入学 资格 是否 与 国内 同 级 同 类 学校 规定 相符 	T
不 解放思想 就 容易 出现 主观 脱离 客观 	M
不 是 为了 单纯 改善 职工 生活 	M
他 是 我 外孙子 的 恩人 	M
人民 生活 水平 有 了 很 大 提高 	M
黑星手枪 二 把 及 赃款 四十万 元 	T
学生 本来 对 自己 的 学期 成绩 就 有 自知之明 	T
真正 伟大 的 是 中国 人民 	M
限额 的 分配 乃 以 有 海外 分公司 及 契约 者 优先 	T
记者 在 此间 举行 的 中 日 经贸 第５ 次 定期 协商 会议 上 得到 一个 印象 	M
是不是 一 到 黄河 大桥 就 鼻 塞 不通 	M
组织 农民 在 这里 挖 泥 封 沙 	M
执政党 内部 又 开始 出现 大老 不同 的 声音 	T
在 安哥拉 东南部 宽多-库邦戈省 的 奎托夸纳瓦莱 至 马温加市 之间 	M
但是 这 种 类似 政治 运作 中 的 人情债 	T
肯定 会 出现 关于 防务 的 争论 	M
使得 目前 仍 在 中心 受训 的 一百余 位 准 国手 有 后顾之忧 	T
台北市 议员 也 屡次 要求 环保局 喷 药 消毒 	T
除了 雕像 和 金 铜 佛像 仍然 付之阙如 	T
具有 国际 自由港 的 地位 自 内 开放 的 经济 体制 和 比较 完备 的 法制 框架 	M
这 已 被 大量 事实 所 证明 	M
斗六市 人 到 莿桐乡 中正路 七十二号 陈振明宅 索 债 未果 	T
这 位 战士 的 父亲 来 说情 	M
凉城县 领导 和 交通 系统 的 职工 们 一起 拥 向 车 旁 	M
六 年 前 转入 体总 及 奥会 后 	T
这里 已 在 ３００ 多 个体户 中 评出 三 县级 售货员 两 人 	M
备 单位 要 加强 对 多种 经营 的 领导 和 管理 	M
人民 可以 提出 管理 国家 大事 管理 社会 事务 的 意见 和 建议 	M
在 不同 的 阶段 采用 不同 方式 的 组合 	T
不论 长 跃 扣 杀 或 对角 的 吊 小 球 	T
不 以 经济 建设 为 中心 	M
事实 上 症候 发生 时 此 病 已 在 体 内 存在 一 段 时期 	T
应当 无 排放 放射线 污染 的 顾虑 	T
以 提升 图形 显像 之 表现 	T
因 该 队 外野 阵容 坚强 	T
不过 冷却 以后 就 会 形成 透明 的 玻璃 	T
犹如 躲 在 壳 中 的 蜗牛 	T
我国 叶彰廷 是 以 总分 第二 名 谢锦升 总分 第四 名 具有 参赛 资格 	T
其 多头 司令军 的 头衔 在 现阶段 似乎 名不副实 	T
这 无疑 大大 增加 了 海部 继续 执政 的 资本 	M
当 整个 楼群 和 道路 基本 完工 后 一部分 购房 者 已 搬进 新居 ） 	M
保证 全国 原油 天然气 生产 的 持续 稳定 增长 	M
他们 第７４ 个 航次 运 去 的 ２５ 吨 活 赤贝 	M
日本 中央 银行 最近 已 决定 从 ４月 起 将官 定 贴现率 降低 百分之零点五 	M
之后 裕隆 紧 守 慢 攻 	T
昨天 迈入 男子组 六 个 量级 的 竞技 赛程 	T
必须 是 把 优势 的 勘探 力量 	M
对 少数 人 发生 的 损害 	T
符合 加州 最 新 的 排放 标准 	T
完成 两百 家 用户 与 头 端 设备 间 的 连线 工作 	T
若 希望 保有 目前 的 生活 水准 	T
在 大陆 投资 多 了 会 增强 大陆 在 国际 市场 上 的 竞争力 	M
帮 的 目的 是 为了 促 	M
都 具有 继续 稳产 的 基础 	M
第三 度 赴 夏威夷 演出 半 个 月 	T
以 每 罐 一千 元 百 粒 装 	T
里民 们 并且 完成 联名 陈情 桃园县 政府 	T
在 我国 环境 保护 各项 工作 中 	M
球迷 对 中华 篮球队 殷切 的 期望 经常 转换为 恨 铁 不 成 钢 的 诅咒 	T
但是 在 大 者 愈 大 的 竞争 夹缝 中 	T
不过 商标局 采信 德隆 公司 的 使用 证据 	T
要 善于 抢占 人才 这个 制高点 	M
以前 认为 早已 成为 历史 现象 的 传统 	T
有 困难 或 问题 去 请教 林汉章 	T
宫内 胎儿 心脏 手术 的 过程 是 	M
则 相约到 饭店 或 宾馆 进行 正式 交易 	T
这些 无暇 走 亲 访友 的 亚运会 建设者 	M
凉城县 县长 武 建中 和 交通局 局长 施 拴元 分别 接到 电话 后 	M
稀罕 的 颜色 可以 换得 极 高 的 利润 	T
场 平均 上座率 基本 保持 在 百分之六十 以上 	M
想 在 我国 北方 建 一 座 乐器 城 	M
台北市 建设局长 夏汉容 昨日 赴 南港 参观 一 家 大型 的 ＧＭＰ 餐盒 工厂 	T
有 义不容辞 的 舆论 宣传 责任 	M
并 希望 扮演 更 具 建设性 的 角色 	T
是 由于 中国 共产党 的 领导 	M
游山 码头 正 与 香港 海翔 仓储 化工 有限公司 共同 投资 	M
了解 每 个 部落 的 文化 	T
需 知 如果 不能 互助 互利 	M
办公室 政治 就 是 与 那些 动不动 就 发牢骚 碎嘴 或 天生 不 受 欢迎 的 人 相处 的 过程 	T
办案 人员 当场 在 上述 地点 搜出 蛇粉 成品 二百六十一 公斤 	T
中国 共产党 能 把 日寇 打 得 落花流水 	M
显然 正在 自己 的 王国 忙著 转来转去 	T
雪梨 申请 主办 二千年 奥运 的 另 一 特色 是 提供 参加 国家 所有 队 职员 交通 食宿 及 大型 运动 器材 的 运输 费用 	T
据 有关 部门 对 电子 企业 的 调查 统计 	M
并 到 虎尾镇 天后宫 二妈庙 参拜 	T
在 ２０ 米 高 的 空中 进行 的 攀 索 运动 	M
以 冷静 理智 的 态度 去 对待 别人 	T
尤其 是 非洲 各国 的 密切 关注 	M
蝴蝶 飞 呀 文 摄影 李俊延 琉璃 波纹 小 灰 蝶 前 阵子 	T
不 跟 上去 是 没 办法 的 	M
第二 个 方案 因 社团 联合会 现已 存在 	T
某 报 记者 在 堤 爆破 行 洪 目击 记 一 文中 	M
只见 六七 个 外省 青年 手里 各 拿 着 二三百 元 直 往 售票 窗 前 挤 	M
而 国内 景气 各 项 指标 每况愈下 	T
北 观 人流 如期 的 黄金 闹市 	M
在 国际 市场 通行 的 经济 运行 机制 	M
原来 就 是 琉璃 波纹 小 灰 蝶 	T
在 世界 经济 格局 的 重大 调整 中 	M
他 第一 个 站 在 连长 跟前 	M
因为 校长 决定 学校 的 风格 与 管理 	T
来 分析 ３Ｄ 心脏 影像 并 帮助 医生 下 诊断 	T
以至于 现在 全国 发展 到 ２００ 多 个 矿泉水 生产 厂家 	M
而 女婿 却 和 内弟 同 挤 一 床 	M
并 露出 一点 砖砌 的 拱门 	T
工会 行政 科 政工 科 打字 室 也 挤 在 一 间 房子 里 	M
影响 着 反 腐败 斗争 的 成败 和 人心 的 向 背 	M
最后 一 球 阿迪 转 拉 底线 	T
为 更 好 地 发挥 监测 对 管理 的 技术 支持 和 促进 作用 	M
不会 挑剔 员工 细微 毛病 而 断 人 前途 	T
筹码 几乎 都 控制 在 公司派 手 中 	T
接受 了 中国 传统 文人 自视 清高 的 影响 	T
３００ 余 名 学生 露天 上课 近 两 个 月 了 	M
不 是 以 产业工人 为 主体 的 广大 工人阶级 	M
依 公务员 服务 法 第一 条 	T
鼓励 家庭 作业 活泼化 一向 是 该 局 的 原则 	T
学校 的 行政 人员 都 是 非常 尊重 大学生 的 	T
会议 决定 由 外长 们 对 政治 联盟 问题 作 进一步 研究 	M
去年 苏州 市区 轻工业 保持 了 持续 上升 的 势头 	M
大锅饭 不 是 化解 矛盾 的 办法 	M
不知 是 广告 的 作用 还是 好奇心 的 驱使 	M
有 些 公司 甚至 建立 一 套 政策 	T
当地 的 报纸 上 登 出 毛 的 女儿 穿 上 了 时装 的 大字 标题 	M
发言 坦承 有 多少 流落 海外 的 台湾人 科技 人才 	T
教育部 希望 明年 三月 的 全 国 词曲 创作 大赛 能 由 文化 主办 	T
别 光 捡 好 的 说 	M
让 民众 陷于 长期 污染 环境 中 	T
光是 营业 面积 就 有 ６万 多 平方米 	M
崩 后 葬 在 昌平县 天寿山 下 后 	T
唯独 缺少 的 就是 市场 意识 	M
补 上 市场 这 一 课 已 成为 摆 在 辽宁 人 面前 的 重要 课题 	M
特别 感谢 国际 游泳 总会 及 主办 单位 澳洲 游泳 总会 	T
这 次 北韩 的 代表团 中 	T
出现 一 种 暂时性 的 阳痿 现象 	T
德克勒克 宣布 的 改革 种族 隔离 制度 的 措施 都 是 出于 无可奈何 	M
公布 财务 盈亏 及 呆帐 情形 	T
为 调动 其 工作 和 成才 的 积极性 	M
继承 了 祖国 美好 的 江山 	M
可 在 入境 后 到 移民局 办理 延期 手续 	T
焦 裕禄 和 他们 一起 吃 糠 咽 菜 的 艰难 日子 	M
他们 分散 在 几 个 中队 里 	M
又 与 疑似 患 此 病 的 人 曾 接吻 过 	T
平均 每 三 个 少年 犯罪 中 	T
另外 １８ 家 则 声称 它们 时常 受到 企业 外部 主要 是 某些 政府部门 的 牵制 和 干预 	M
鸡 叫 鱼 跳 肉 鲜 菜 嫩 	M
代为 邀请 客户 帮助 工厂 改善 与 国营 商业 主渠道 的 关系 	M
肯尼 罗杰斯 及 松田圣子 写 过 红 极 一时 的 歌曲 	T
在 广东 追赶 四 小 龙 的 过程 中 起 骨干 和 带头 作用 	M
名列 台湾 最 大 室 内 剧场 的 国父 纪念馆 大会堂 	T
接着 又 往 外 一 滑 	M
但是 书籍费 三千 元 却 必须 等到 一 个 学期 后 才 能 领到 	T
苏联 的 能源 材料 己 居 世界 前列 	M
看到 这里 所有 的 教室 宿舍 办公室 和 实验室 均 被 洗劫一空 	M
两亿 的 资本额 已 亏蚀 一亿多 	T
才能 缓解 资金 紧张 的 局面 	M
对于 刚刚 结束 的 那场 恶梦 	M
前来 理 货 的 苏联阿穆尔 州 农工委 主任 工程师 亚历山大 操 着 流利 的 汉语 对 记者 说 	M
第一 分局 系 于 前天 下午 三时 余 接获 民众 检举 	T
二氧化碳 在 平衡 的 生态系 中 	T
方便 职工 生活 等 多方面 的 重要 作用 	M
如 研发 高速 与 宽频 通讯 技术 数位 视讯 技术 微电子 系统 发展 四 年 计划 等 	T
某 厂 党委 一 位 领导 	M
这 对 促进 香港 和 各国 的 经济 往来 以及 巩固 香港 经济 的 国际 地位 是 十分 必要 的 	M
不同于 以往 工人 游行 的 是 	T
但 大陆 除 部份 大 城市 外 	T
扶持 １７ 个 乡镇 和 ６ 个 县属 单位 办起 ２３ 个 集体 水果 场 	M
据 熟悉 内情 的 同志 介绍 	M
当场 许多 参与 者 指责 该 乡公所 涉嫌 护标 	T
对 砸 箱子 的 事 你 怎么 看 	M
两 国 人民 之间 存在 着 悠久 的 传统 友谊 	M
在 胡适 先生 和 多 位 科学家 的 倡导 下 	T
无私奉献 的 生 人命 责任感 不断 增强 	M
而 荣获 最佳 儿童 节目 主持人 奖 	T
让 饲主 布置 在 住家 周围 	T
有人 对 这个 损失 ２０万 元 的 回马枪 不 理解 	M
往往 站 在 卢 泰愚 一边 	M
由于 无力 进行 大规模 技术 改造 	M
这些 不同 层次 的 空间 资料 基本 上 都 是 具有 空间 关系 的 数值 资料 	T
以 对 知识欲 具 强烈 愿望 的 处女座 思考力 	T
洪水 围困 十二 昼夜 十万 灾民 生计 如何 	M
邮寄 或 迳 送 本 院 秘书组 二科 	T
几乎 所有 的 周末 报 都 在 文化 上 做文章 	M
记者 在 科威特城 的 几 条 主要 街道 看到 	M
检验 项目 包括 人工 甘味 生菌数 大肠 杆菌 等 	T
学校 在 公馆 征收 的 校地 	T
而 老字号 的 国军 文艺 活动中心 	T
他 还 谈到 中国 要 保持 稳定 	M
好像 有 什么 地方 不太 对劲儿 	T
当 新 班子 遇到 麻烦 困难 的 时候 	M
猛地 窜 到 记者 面前 问 	M
警方 正 庆幸 验尿 问题 终 获 解决 	T
只有 贫弱 的 南方 才 依赖 北方 	M
其中 两 张 为 化名 的 假 身份证 	M
墨西哥 总统 是 昨天 抵达 里斯本 对 葡萄牙 进行 两 天 工作 访问 的 	M
还是 在 表示 民 富 国 强 	T
而 学生 亦 肯定 国语科 家庭 作业 的 功能 	T
能否 就 最后 一点 说 些 具体 内容 	M
天 地 君 亲 师 在 中国 社会 象征 一 个 人 生命 开展 的 要素 	T
将 原本 较 长 且 艰深 的 史诗 加以 诠释 	T
此外 还有 许多 成果 在 国内 首屈一指 	M
竹东镇 都市 计划 委员会 提到 县都委会 的 变更 理由 是 	T
所以 我们 将 思考 方法 加入 学校 课程 	T
他 的 学生 是 和 他 一样 的 犯人 	M
让 弄潮儿 舒展 手脚 乘 风 踏 浪 	M
资本主义 的 香港 与 社会主义 的 内地 在 中国 这个 大家庭 里 将 会 长期 共存 	M
要 充分 尊重 南方 国家 决定 本国 经济 社会制度 发展 模式 和 经济 政策 的 主权 	M
马球 的 故乡 西藏 却 逐渐 把 它 遗忘 了 	M
大多数 同学 都 表示 可以 接受 这 方式 	T
其 大小 与 一般 名片 略同 	T
科研 人员 还 在 新疆 探明 了 一个 钨 锡矿 靶 区 	M
则 避 而 不再 见 了 	M
海湾 战争 刚刚 结束 的 一个 月 之内 	M
针对 学习 外语 的 弊病 及 困难 	T
而 洋人 又 需要 什么样 的 国货 	M
感谢 总书记 对 我们 的 关怀 	M
该 会 为 迎接 十一月 二十日 的 国际 儿童 人权日 	T
以 酵素 抑制 剂 来 抑制 疼痛 	T
各级 干部 一定 要 以 江 泽民 总书记 提倡 的 谈泊明志 	M
尤其 注重 缓释 疏导 病人 情绪 	M
在 应对 时 不 露 风声 	T
工研院 日前 向 经济部 技术处 提出 八六年 科专 申请案 	T
必然 会 带来 这样 那样 的 问题 	M
桃园县 刑警队 昨 将 全 案 依 掳人勒赎 罪嫌 	T
我 选 了 一 家 湖 旁 餐厅 用餐 欣赏 卡贝尔桥 的 夜景 	T
试想 有 ７００万 人口 的 大 武汉 	M
游泳 排球 等 各 项 运动 也 是 一把 罩 	T
却 被 雾峰乡代 赖进权 拍下 挖土机 掩埋 垃圾 的 照片 	T
在 高消费 闻名 的 台北 东区 最为 明显 	T
不时 一 天 要 分身 应付 ３ ４ 个 会 	M
美国 人 是 边 说 边 做 	M
成功 大学 建筑系 教授 林宪德 指出 	T
十二月 二十七日 周复初 针对 此 事 召开 社团 负责人 会议 	T
我们 也 与 有 荣 焉 	M
此时 韩国 教练 再 一 次 叫嚣 抗议 	T
广州 经济 发展 就 会 后劲 不足 	M
也 是 中国 当代 工人阶级 不可 改变 的 志向 	M
曾 连续 三 度 夺得 澳洲 公开赛 女子 单打 冠军 的 德国 好手 玉罗刹 葛拉芙 	T
我 今年 不 准备 包 这么 多 地 了 	M
历经 四十多 年 的 符咒 经营 	T
北京 人 曾 为 买 不到 啤酒 而 牢骚 满腹 	M
全县 半数 以上 的 耕地 实行 了 农 桐 间作 	M
还 需要 坚持 唯物主义 的 勇气 	M
主要 原因 是 生菌数 标准 不同 	T
走 在 卷 帙 浩瀚 的 西藏 档案馆 里 阿沛 副 委员长 显得 精神抖擞 	M
从而 很 好 地 发挥 了 包括 大 知识分子 在内 的 全体 首钢 人 的 智慧 和 力量 	M
西藏 民族 体育 漫谈 之 三 	M
我 今年 要 把 ６０ 多 亩 小麦 和 ６０ 多 亩 棉花 种 得 更 好 	M
但 考虑 开放 国外 的 相互 保险 公司 来 台 设立 分行 	T
他 印象 中 的 较 大 伤亡 车祸 不 超过 五 件 	T
而 这 份 华夏 民族 的 大一统 文化 	T
就 是 来自 于 画家 邱锡勋 手 下 	T
焦急 万分 的 妈妈 一边 敲门 一边 喊 	M
也 丧失 了 购物 的 乐趣 	T
最 常 见 的 是 铁锤 与 钉子 	T
至于 保险司 的 组织 架构 为 置有 司长 	T
掌声 在 ５５年 夏天 的 时候 	M
豪华 大方 的 ２５ 升 冰箱 也 吸引 了 不少 买主 	M
在 死 前 的 犹豫 中 	M
我国 人均 纤维 消费量 由 １９７８年 的 ２．４ 公斤 到 １９９０年 的 ４ 公斤 	M
目前 景气 已 有 回升 的 迹象 	T
而且 可以 体验 古早人 的 生活 方式 	T
有 个 企业 为了 优化 生产 布局 	M
光 谈 电脑 已经 愈来愈 难 窥 未来 资讯 世纪 的 全貌 	T
同时 要求 大学生 应 正视 全民 健保 法 带给 社会 的 冲击 	T
以至 常熟 叫 化 鸡 德州 扒鸡 温州 八 珍 鸡 等 失去 了 昔日 风采 	M
才能 使 苏 宁 在 军营 默默 耕耘 了 ２２ 年 	M
那 是 村 外 的 一 片 坟地 	M
但是 该 基金 多 年 来 先后 缴库 五十亿 元 	T
智邦 科技 日前 对 大中华区 发布 新 的 人事 命令 	T
而 寒假 则 进行 学生会 组织 章程 的 修定 和 拟定 社团 经费 分配 方法 	T
他们 派员 在 日本 建立 了 三 个 信息 点 	M
由于 数 年 前 西滨 公路 要 拓宽 	T
认为 妨害 公务 罪 初犯 者 实 应 列入 减刑 范围 	T
均 利用 航空 照片 及 人工 判释 	T
最近 在 丹麦 完成 的 一 项 研究 显示 	T
进一步 贯彻 落实 中央 和 省委 关于 反 腐败 斗争 的 指示 精神 	M
只要 一个 班 在 上 音乐课 	M
中华 奥会 主席 张丰绪 近日 将 动身 前往 菲律宾 马尼拉 	T
上海市 演出 公司 的 同志 大多 来自 于 当地 各 文艺 剧团 	M
限令 草屯 不准 再 在 此 处 倒 垃圾 	T
我 感到 我们 的 人民 听 党 的 话 	M
就 赶上 了 铸造厂 扭转 生产 上 瓶子 口 被动 局面 的 大会战 	M
面对 淡水河 口 及 观音山 的 风光 水色 时 	T
４０万 职工 紧 衣 缩 食 	M
一举 取消 了 坚持 多年 的 工效 挂钩 改革 办法 	M
才能 使 武汉 人 在 大汛 面前 安居乐业 	M
而且 从 设计 土建 安装 到 调试 生产 全部 要 从头 搞 起 	M
如今 却 又 给 人们 带来 苦涩 的 疑惑 	M
虽然 使用 电脑 作为 主要 工具 	T
并 采取 多孔性 的 地面 设计 	T
网球 表演赛 由 李 院长 和 彭旭明 先生 罗 副院长 伉俪 均 分别 下场 竞技 	T
为什么 郑州市 邙 山区 检察院 今年 ８月 ７ 号 开展 侦察 工作 	M
平均 每天 营业额 达 ３００ 多元 	M
首先 各级 领导 要 增强 科技 意识 	M
竞标 者 计有 黄文瑞 等 十七 人 	T
采访车 停 在 我 家 门口 	T
海部 总算 相继 打 掉 安倍 派 和 渡边 派 的 要求 	M
开辟 一 广大 视野 让 国内 研究 机构 企业 学校 	T
明 两 天 至 丰西 社区 活动中心 报名 	T
股东 董事会 减 量 经营 压力 极 大 	T
苏 宁 便 撰写 和 修改 了 三 篇 论文 	M
日 美 两 国 关系 面临 严峻 的 局面 	M
所以 若 使用 的 不 是 等级 较 高 如 无菌 已知菌 无 特定 病原 可以 控制 影响 因素 为 唯一 的 实验 动物 	T
均 在 设法 扩大 自己 的 势力 和 影响 	M
令 人 看 了 不禁 心酸 无奈 	T
就 这样 被 大 把 大 把 地 挥霍 掉 	M
普雷 的 优势 在于 能 提供 国内 厂商 更 快速 而 切合 需求 的 服务 	T
以 挫败 以色列 庞大 的 移民 计划 和 吞并 阿拉伯 领土 的 阴谋 	M
我 原 以为 计算机 很 神秘 	M
管理 训练 有助于 降低 员工 流动率 	T
大型 的 团体 旅客 还 可以 特别 安排 	M
玉器 陈列室 在 前年 换 展 	T
这 里面 充满 了 实在 生活 的 经验 	T
多 是 各 部会 相关 单位 先 沟通 看法 	T
轮流 于 每 年 十月 展出 四十 天 	T
曾庆瑜 为 能 唱 他 所 写 的 歌 而 雀跃 不已 	T
由于 工具 软体 对 软体 公司 的 竞争力 十分 重要 	T
在 县 内 各 超级市场 便利商店 及 学校 附近 的 商店 	T
青海 海南 藏族 自治州 塘格木 河卡 一带 发生 ６．９ 级 强烈 地震 	M
又 要 有 一定 的 资金 投入 	M
台塑 六轻 计划 此 番 重回 利泽 的 如意算盘 是否 能 如愿 	T
现在 这 ８ 条 龙 已 有 ８２ 支 代表队 	M
纯利 由 １．２万 元 增加 到 ８３万 元 	M
做 必要 的 澄清 事实 的 工作 	M
分别 因 在 生物 及 数理 研究 工作 上 的 卓越 成就 而 荣膺 一九九三年 侯金堆 杰出 荣誉 奖 得主 	T
经过 大胆 的 临床 探索 和 实践 	M
田 纪云 罗 干 等 同志 对 救灾 工作 作 了 具体 指示 	M
中国 乒乓球队 领队 姚 振诸 总 教练 许 绍发 副总 教练 张 燮林 告诉 总书记 	M
这 条 高 ２．４ 米 长 ７．４ 米 的 庞然大物 	M
我 的 私房钱 都 用 到 了 桥 上 路上 	M
贺 龙 的 夫人 薛 明 向 记者 描述 着 自己 兴奋 的 心情 	M
迁 台 后 的 故宫 到底 缺 了 哪些 宝物 呢 	T
因此 中华 奥会 将 在 今天 的 执委会 中 	T
是 一 种 相当 危险 的 毒物 	T
进度 比 往年 整整 提前 五 天 	M
技术 含量 高 的 产品 销 不 动 是 国家 紧缩 政策 的 效应 	M
其中 在 三十一日 晚间 已 有 两 艘 韩国 渔船 和 四十余 艘 香港 渔船 	T
这 锤子 挥 得 很 不 轻松 	M
王永庆 的 大 儿子 王文洋 立即 过来 安抚 父亲 	T
从 民国 五十一年 拍摄 电影 梁山伯 与 祝英台 开始 	T
在 江苏省 阜宁 县 化纤 厂 会议室 里 	M
吃 完 榨菜 后 把 包装纸 扔 在 脚 边 	M
给 轰轰烈烈 的 大 联展 蒙 上 了 一 层 阴影 	M
在 国小 一 到 六年级 一万两千四百七十四 人 中 	T
我国 境 内 看 不 见 	T
对 建国 ４２ 年 来 特别 是 改革 开放 １０ 年 来 衣食住行 所 发生 的 巨大 变化 	M
东海 校园 规划 委员会 是 由 校长 行政 人员 以及 建筑系 景观系 教授 组成 	T
勘探 程度 也 是 低 的 	M
清朝 的 珐瑯彩 根本 挖 不 到 	T
老 觉得 自己 是 只 寄居蟹 	T
首先 我们 选中 了 这个 地方 	M
仅 达到 国家 基本 要求 的 一半 	M
检方 先 将 验尿 工作 指示 由 查获 警方 直接 送 卫生局 	T
在 １１ 城市 一 商 局长 会上 	M
文教组 与 家访组 成员 没有 科系 上 的 限制 	T
小 刘 帅 无恙 任 志庆 脱险 	M
就 到 了 快乐 星 上 的 观星室 	T
据 出席 的 县 议长 郑永金 表示 	T
昨天 投出 的 变化球 大都 为 正中 转 内角球 	T
除了 交通 工具 工厂 及 空调 设备 的 排 热 外 	T
可 由于 我们 过去 不 重视 产品 宣传 和 销售 服务 	M
为了 南浦 大桥 能 有 今天 	M
自从 苏联 军队 ２０日 开进 阿塞拜疆 首都 巴库 之后 	M
就 可 挖 出 很 大 潜力 	M
我们 记述 的 是 发生 在 二 连 的 几 个 平凡 的 故事 	M
齐白石 的 农民 性格 成为 支配 他 一生 思想 行为 与 艺术 活动 的 基础 	T
美国 希望 改善 与 拉美 国家 的 关系 	M
在 这些 经济 的 非经济 的 综合 因素 促使 下 	M
妳 先生 其实 也 和 妳 一样 对 婚姻 生活 之 适应 有 困难 	T
体育 新闻 篮球 是 休闲 运动 	T
让 居民 生活 好 过 一些 	M
新 的 作战 方式 的 出现 	M
正 值 八 厘米 小型 摄影机 	T
故宫 对 当年 从 北京 故宫 及 南京 中央 博物院 带出 的 文物 	T
这 批 不 合格 箱子 出 在 我们 手里 	M
江汉 关 水位 在 ２６．９４ 米 时 	M
怎样 实现 计划经济 与 市场 调节 的 有机 结合 	M
在 夜间部 定位 模糊 的 问题 方面 	T
在 明年 一月 双方 重回 谈判桌 以前 	T
台大 的 情况 也 是 如此 	T
镇长 蔡文正 前天 晚间 也 拨 了 不少 通 电话 	T
台大 外文系 四年级 泰雅族 学生 陈惠贞 强调 	T
结果 大部分 学生 赞成 设置 磁卡制 	T
就 像 在 教 学校 学生 一样 	T
香港特别行政区 可 在 经济 贸易 金融 航运 通讯 旅游 文化 体育 等 领域 以 中国 香港 的 名义 	M
一旦 伊拉克 和 科威特 之间 的 争端 最终 得到 解决 	M
目录 树 的 结构 尽可能 宽 而 浅 	T
日本 政府 也 担心 日元 贬值 会 引起 国内 物价 上涨 	M
日本 今后 将 以 何种 形式 扩大 自己 的 国际 影响 	M
人人 都 会 感觉 到 自己 身边 衣食住行 的 变化 	M
两 位 教授 之 研究 专长 均 为 变分学 	T
热情 地 欢迎 小平 同志 的 到来 	M
应当 立即 把 职能 转变 到 新 技术 的 引进 和 推广 上 	M
ＶＩＳＳＲ 的 数位 资料 可 用来 估计 海面 温度 云量 云高 等 参数 	T
口味 有点 类似 蛋白 的 香味 	T
我们 发展出 一 简易 之 处理 模式 	T
因此 对 伊拉克 的 所有 制裁 都 必须 解除 	M
目前 该 中心 均 定时 挑选 条件 较 佳 的 智障生 至 咖啡厅 实习 	T
该 案 基地 面积 三千八百 坪 	T
没有 必要 再 呆 下去 了 	M
比 上年 同期 增加 两 倍 以上 	M
如果 系 以 行业别 来 限制 罢工 	T
我 决定 自己 动手 来 写 这 分 教材 	T
尤其 是 对 正在 酝酿 和 谈判 中 的 气候 变化 框架 公约 生物 多样性 保护 公约 以及 森林 等 问题 	M
限展 书画 精华 特展 是 这 次 故宫 特展 的 重头戏 之 一 	T
除此以外 者 均 可 依法 组织 工会 	T
在 充分 了解 行情 的 基础 上 	M
到 地方 肯定 能 混 出 个 样 儿 来 	M
社会主义 企业 同 资本主义 企业 的 本质 区别 在于 	M
许多 时下 的 年轻人 生长 于 安逸 	T
现 已 成为 拥有 设计 和 制造 雷达 广播 电视 仪器 仪表 汽车 电器 电子器件 生产 技术 类 等 ７ 大 系列 产品 能力 的 大型 电子 企业 	M
调解人 得以 拟定 了 包括 这些 让步 的 ３ 个 供 签署 的 文件 	M
我们 必须 在 积极 发展 自己 的 科学技术 的 同时 	M
以便 刺激 投资 和 带动 景气 	M
一 扫 １０ 年 前 单一 和 紧缺 的 局面 	M
可以 接收 偏远 地区 及 海 上 观测台 观测到 的 数据 	T
旅日 华侨 林宗毅 捐赠 朱熹 的 书易系辞 	T
就 更 进一步 想 教 他 如何 来 运用 这些 符号 	T
即使 拥有 位 高 权 重 利 厚 的 结果 	T
价钱 则 丰 俭 由 人 	T
但 听说 今晚 亚运 圣火 要 来 	M
第一 大 在野党 总裁 金 大中 从 一 开始 就 坚决 反对 保守 势力 大 联合 	M
每 个 社会 都 有 婚姻 制度 	T
已 远 不能 满足 人们 在 住房 上 的 需求 	M
该 公司 既是 业界 大 厂 	T
西德 和 日本 的 利率 上升 后 	M
公司 已 紧急 召开 会议 处理 	T
在 无 地方 首长 及 民意 代表 陪同 下 	T
今年 １０月 ３日 德国 的 重新 统一 	M
一 位 名叫 艾哈迈德 的 青年 对 记者 说 	M
这 对 都市 的 发展 助益 并 不 大 	T
七 剧 本身 强调 的 是 与 民间 结合 的 通俗性 	T
纪念馆 这 种 妾身未明 的 状况 	T
有 义务 在 技术 转移 及 资讯 交换 上 扮演 积极 的 角色 	T
美国 对于 召开 中东 和平 国际 会议 始终 坚持 拒绝 立场 	M
而 七十 年 的 建 馆 	T
但 不 包括 其他 雇员 或 约聘 人员 	T
而 现行 市面 上 电脑 主机板 	T
欧洲 共同体 各国 首脑 ４月 ２８日 在 爱尔兰 首都 都柏林 举行 了 一 次 特别 会议 	M
但 中央 正 大力 加强 精神文明 建设 已 形成 大气候 	M
一 高 个 男 青年 从 她们 背后 猛扑 过来 	M
王 心 茂 一家人 就 住 在 林中 小 屋里 	M
昨天 这 项 民众 抗议 的 过程 	T
改变 原来 新村 的 规划 布局 	M
从 二月 二十三日 到 三月 十六日 	T
这个 装 上 了 电话 的 公司 却 一再 恳求 大事 化 小 	M
以 玻璃窗 瓶子 等 日用品 广泛 使用 的 钠 钙 玻璃 为 例 	T
但 设计 和 广告 花费 不赀 	T
这 他 才 不 好意思 的 笑 了 	T
暗香 是 姜夔 在 写 此 词 时 新 制 的 一 首 曲 	T
经过 一 年 多 的 培养 锻炼 	M
金额 差距 也 造成 员工 较之 往年 更加 计较 	T
也许 有时 忘记 了 我们 也 正在 写 历史 	T
这 是 对 人类 社会 进步 的 伟大 贡献 	M
争 睹 这 座 跨度 ４２３ 米 	M
凡是 拿 得 到 学位 而且 最好 是 美国 顶尖 学府 学位 的 人 	T
深圳 经济 作为 建 没有 中国 特色 社会主义 的 探路 尖兵 	M
则 恐怕 要 自己 贴钱 啰 	T
这 是 我国 首 次 在 一个 大 区域 内 较 全面 地 评估 了 一般 人群 中 遗传病 的 本 底 状况 	M
可 提供 比 现有 网路 达 １５０ 倍 以上 之 效能 	T
然而 远 水 不解 近 渴 	M
最初 是 由 检方 受理 警方 移送 人犯 及 证物 尿液 后 	T
全省 ６０％ 的 国营 企业 亏损 	M
所以 劳委会 乃 委托 救国团 办理 以 劳工 青年 为 中心 的 心理 辅导 专线 	T
由 近史所 研究员 陶英惠 先生 接任 迄 今 	T
玉器 有 雕纹 玉琮 蚩尤 环 刻符 玉璧 等 	T
头 肩 底 型态 俨然 出现 	T
一 位 老农 手 拿 着 几 角 零钱 	M
在 市场 上 具有 呼风唤雨 能力 的 华隆 集团 	T
这 场 争论 反映 了 联盟 内部 对 变化 了 的 世界 现实 和 北约 传统 战略 的 深刻 分歧 	M
胜 者 为 王 败 者 为 寇 	T
在 交叉 边缘 学科 上 作 文章 	M
任 志庆 不禁 大 减 一 声 	M
可 做 骨髓 移植 手术 要 花 ３万 多元 钱 	M
美国 副 总统 奎尔 正在 拉美 致力 于 修补 在 美军 入侵 巴拿马 后 美国 与 拉美 国家 的 关系 	M
如果 能 配合 现代化 的 净水 技术 	T
现在 的 关键 就 在于 如何 贯彻 实施 	M
整 个 营建 工程 历时 ６ 年 	T
这 批 佛像 正 可以 补足 故宫 佛教 文物 的 系统 	T
因为 埋 管 工程 比 一般 管线 艰困 	T
保证 本 单位 生产 工作 和 学习 的 正常 进行 	M
有 各 群众 团体 的 民主 管理 制度 	M
产业 结构 失衡 是 造成 库存 积压 的 主要矛盾 	M
该 新村 的 楼房 在 规划 兴建 时 已 被 单位 或 个人 订购 	M
让 该 集团 另 一 关系 企业 京圆 营造 	T
儿童 抗御 污染 的 能力 比 成年人 脆弱 得 多 	M
使 全场 水果 种植 面积 达到 ４．５万 亩 	M
是 最 珍贵 的 精神 财富 	M
由于 美国 经济 今年底 可能 衰退 	M
我 当时 看见 孩子 扒 在 １５ 层 楼 的 窗台 上 	M
我们 办起 事 来 就 会 顺利 得 多 	M
竹 壳 暖瓶 辣椒酱 方便面 挖 野菜 的 小刀 	M
联盟 方面 仍 未 改变 要求 共同 决策 立场 	M
第７ 轮 谈判 将 长达 一个 月 	M
只要 说 对 儿童 有 营养 	M
还是 收缩 阵地 突出 重点 呢 	M
同 健全 民主 制度 是 一致 的 	M
愿 出价 高过 七十三万 元 者 大有人在 	T
他 这个 普通 党员 把 党 和 人民 的 利益 融汇 于 胸中 	M
都 躲 著 小 灰 蝶 的 幼虫 	T
顺利 捕获 安仔子 林万能 及 三 名 少年 	T
商场 赶紧 派 人 从 珠江 三角洲 的 企业 	M
为 考量 球员 有 为 球队 争取 胜利 的 荣誉感 	T
我们 正是 靠 了 这块 招牌 	M
还有 的 是 由于 连队 干部 或 班长 战友 托 他们 办 私事 	M
锁定 听 学 时 的 思路 	T
增强 后劲 攀 高峰 的 口号 	M
并 约谈 该 厂商 负责人 刘傅雄 四十九 岁 	T
把 自己 的 孩子 放到 二 连 当兵 	M
这 完全 是 人为 制造 的 灾祸 	T
把 管理 工作 提高 一 步 	M
希望 人们 在 产业 结构 调整 中 都 能 从 本 企业 的 实际 出发 确立 科学 的 取舍 观 	M
蔡文正 和 古义河 等 获得 代表 们 分别 在 电话 中 的 说明 	T
有时候 反而 给 人 四角 八方 的 古板 印象 	T
还 把 他 钉 在 了 最 苦 最 累 的 五 线 造型 的 第一 道 工位 	M
林汉章 只是 不断 收集 有用 的 资料 	T
想 在 大陆 获得 特别 待遇 	T
而 大盘 能否 向 上 挑战 五千 点 	T
社会 上 多 一 个 像 林汉章 这样 的 爱书人 	T
打击 乐团 演出 儿童 国乐 天地 	T
西螺镇 往 虎尾 郊区 公路 上 昨天 清晨 发生 一 桩 意外 事故 	T
餐车 为 您 准备 了 丰盛 的 午餐 	M
老太太 指 着 另 一个 人 说 	M
到 今年 ７月 召开 西方 国家 首脑 会议 前 	M
清大 以 四 比 一 领先 本 院 	T
而是 农 林 牧 渔 工 商 运 建 综合 发展 的 大 农业 	M
乡村 姑娘 和 小伙子 工余 穿着 也 讲究 起来 	M
其实 也 就 是 他 心志 的 表白 	T
但 地方 人士 怕 带来 赌博 歪风 	T
现有 科技 人员 的 潜能 远 未 充分 发挥 	M
所以 造成 第三 批 彩券 品质 远 比 第一 	T
我 没有 像 其他 同学 那样 嘶哑 着 嗓子 给 围观 群众 讲述 路透社 消息 	M
雪梨 为 申办 二千年 奥运 在 台北 举行 正式 记者会 	T
在 国民 普遍 受 教育 下 	T
世界 多极化 的 趋势 有 了 明显 发展 	M
对于 参加 训练 并且 达到 特定 成果 的 员工 给予 奖励 	T
还是 被 一 退 再 退 这 一切 只 因 他 的 前科 	T
在 事先 准备好 的 啤酒 里 下 安眠药 	T
目前 现任 的 棒协 理事长 唐盼盼 所 担任 的 中央 通讯社 社长 	T
教派 之间 的 武装 流血 冲突 时有发生 	M
皆 是 来自于 庭硕 学 拼音 	T
１０ 多 亿 元 的 巨款 能 取得 １０％ 的 利润 已 属 不易 	M
海水 淡化 机组 设备 所 生产 的 淡水 	T
哪 料 身后 的 冲击波 一阵 强 似 一阵 	M
都 曾 是 凌虐 海龟 的 顽童 	T
学生 还是 可以 到 教务处 查 	T
他 投入 了 一 年 余 时间 与 心力 	T
而且 对 经营 场所 这个 外在 的 包装 也 十分 重视 	M
其 依然 逃脱 不 了 跪 在 岳 墓 前 遗 千古 唾骂 之 命运 	M
而 占用 起诉 后 才 申请 承租 者 	T
正 是 向 前 迈 大 步 更 上 层 楼 的 最佳 时机 	T
扩 销 的 目标 有 可能 实现 	M
如果 世界 走向 多元 分化 和 地球村 的 出现 	T
今天 是 人 在 使用 电脑 网路 互相 沟通 	T
相对的 国内 就 有 一 吨 的 废纸 可能 因为 无法 消耗 而 成为 垃圾 	T
展 在 国际 雕刻 名家 之 作 萃集 的 雕刻之森 	T
并且 汇集 各界 的 意见 修改 完成 	T
并 于 去年 ７月 首 次 向 日本 出口 食用 酒精 １６７ 吨 	M
使得 高解析力 卫星 影像 成为 都市 交通 建设 规划 与 监控 之 一 大 利器 	T
后来 他们 听到 有 人 叫 他们 	T
这 项 最 新 的 情报 发现 与 美国 情报 官员 最近 所 作 的 一 项 最 坏 情形 估计 略 有出入 	T
并 希望 它 能 保持 词 的 原 韵味 	T
一方面 了解 公司 的 体质 人脉 和 通畅 	T
最近 每天 约 通过 ７０００ 辆 车次 和 ２０００ 人次 	M
我 被 接收 为 中国 共产党 党员 	M
包括 一些 专业性 很 强 的 如 统计 医药 等 方面 的 书 都 有人 买 	M
从未 见 过 如此 不 合理 的 情形 	T
才 能 改善 与 同事 的 关系 	T
她 也 未必 能 懂得 这 就 是 错 	T
而且 在 实践 上 也 常 不自觉 地 扮演 一 种 助纣为虐 的 角色 为 现实 的 既得利益 造势 	T
由于 ２０世纪 初期 美国 的 机车 工业 并 不 发达 	T
还 打算 你 爷爷 开口 求饶 不成 	T
争取 在 ９月 底 或 １０月 初 开学 	M
每 位 受训 者 都 会 收到 一 份 笔记 	T
只有 舍 前者 而 取 后者 才 是 上策 	M
雪梨 特别 派出 新南威尔斯 体育部长 唐宁 来 台 	T
原因 是 她 和 今夜 星光 的 制作人 俞凯尔 之间 的 恋情 曝光 以后 	T
在 两 个 月 时间 里 	M
四 我们 应该 撤离 天安门 广场 	M
这 两 处 电话 连 着 改革 开放 的 大业 	M
分别 假 植物所 和 活动 中心 会议室 圆满 召开 	T
南京 高能 计算机 所 开拓 市场 的 新思维 	M
滔滔不绝 地 向 记者 倾 谈 自己 的 感受 	M
集结 四 支 职棒队 菁英 的 中华 联队 四 战 皆 墨 	T
明日 世界 太空 剧场 自 开放 以来 广 受 小朋友 与 民众 的 喜爱 	T
试验 的 结果 无非 是 两 条 	M
发现 绩优组 的 高级 主管 多 属 内 升 	T
最 著名 的 澳洲 女 导演 	T
如此 很 容易 使 人 与 人 的 关系 变成 不 稳定 复杂化 	T
人民 之 权利 义务 应 以 法律 定 之 	T
多极化 局面 正 成为 客观 现实 	M
为了 落实 中央 的 有关 精神 	M
外胎 都 扎 成 刺猥 了 	M
所以 两 人 就 往 土城 试 运气 	T
只见 郭 副 省长 微笑 着 从 台上 左侧 的 人群 中 站 起 	M
更 使 人 感到 烦躁 难受 	M
并 不能 定义 中华民族 作为 生命 共同体 的 价值 取向 	T
镇长 积极 与 代表 连络 双方 拟 择期 沟通 	T
我们 很 客观 地 指出 它 是 不当 的 	T
他们 决心 取得 群众 的 理解 与 支持 	M
我们 并 不 是 在 美国 背后 搞 花样 	T
知道 他 会 有 冒险 刺激 的 未来 吗 	T
未 经 入学 修业 获得 论文 学位 证书 	T
印度 政府 于 １月 ２１日 下令 军队 开进 斯利那加市 	M
加上 医疗 品质 不佳 的 问题 	T
同时 也 与 相关 的 属性 资料 相 连结 于 ＧＩＳ 的 资料库 管理 系统 中 	T
而且 是 个 重大 实践 问题 	M
国家 在 发展 环境 保护 事业 中 十分 重视 和 大力 支持 发展 环境 监测 工作 	M
连接 着 北京 工人 体育场 先农坛 体育场 国家 奥林匹克 体育 中心 等 ２０ 多 个 亚运会 比赛 及 训练 场馆 	M
汽车 一个 急刹车 停 在 车场 上 	M
但 总统 认为 这 是 地方 事务 	T
法国 在 中东 的 外交 政策 不会 听从 任何人 的 摆布 	M
自 本 （八十三） 年 七月 正式 签约 后 	T
譬如 有 些 公司 注重 少 说 多 做 的 文化 传统 	T
县 体委 又 在 教委 的 支持 下 	M
没想到 欧巴桑 不仅 未 处罚 我 	T
严重 制约 了 油田 的 高效 开发 	M
最终 是 钓 客户 的 广告 	M
我们 并 不 是 在 谈 攻击 的 日期 	T
因为 我 是 从 车间 里 滚 出来 的 	M
他 认为 小赵 当众 给 他 难堪 	M
任 志庆 经 抢救 也 脱离 危险 	M
完成 预期 中东 供 油 减少 时 的 各 项 因应 措施 	T
从 油田 勘探 的 实际 情况 出发 进行 认真 分析 	M
这些 测验 多半 很 便宜 或 甚至 免费 	T
西延 线 铺轨 到 延安 纳 庆典 	M
是 反映 人民 群众 的 意见 发挥 监督 作用 的 一 条 重要 渠道 	M
墨西哥 总统 卡洛斯·萨利纳斯 在 这里 说 	M
从 另外 一 个 角度 而 言 	T
对 任何 事 不会 一味 地 顺从 	T
兰考 火车站 每年 平均 装车 外运 的 粮食 棉花 桐材 油料 等 有 １亿 多 公斤 	M
把 东 西 文化 齐聚 一 堂 	T
他 的 讲解 赢 来 了 一 片 掌声 	M
即 是 产品 个性化 的 一 种 必然 趋势 	T
担负 电视塔 施工 任务 的 北京 建筑 工程 总公司 第六 公司 的 干部 工人 	M
摸清 了 四川省 普通 人群 中 遗传病 的 种类 顺 位 频率 和 分布 	M
是 十 月份 的 一点五 倍 	T
气温 上升 也 会 对 生态系 及 农业 带来 很 大 的 影响 	T
道教 道士 赵归真 等 又 排斥 佛教 	T
美 苏 的 态度 对 解决 安哥拉 问题 起 着 重要 作用 	M
８２％ 的 企业 认为 他们 拥有 较 充分 的 自主权 	M
乘 丹东 牌 黄海 大客车 向 呼市 方向 进发 	M
但是 这 一 建议 遭到 西德 总理 的 拒绝 	M
但是 我们 需要 有 很 强 的 董事会 	T
在 熙熙攘攘 的 商场 内 转 了 一 圈 	M
而 日本 相互 保险 公司 则 扮演 中性 法人 角色 营利 色彩 较 淡 	T
谢 丽娟 指 着 柜台 后面 乌黑 的 地面 上 堆放 着 的 一块 块 白净 的 猪肉 	M
我 心 中 久久 地 回响 著 错 	T
奔跑 时 可 帮助 身体 保持 平衡 	T
抓好 多种 经营 增强 自我 发展 能力 	M
现在 适之 先生 的 文稿 多 已 归档 	T
来自 法国 罗浮宫 的 风景 油画 挂 在 赭红色 的 墙壁 上 	T
在 棺 左右 放有 ２６ 只 盛满 殉葬物 之 红 漆 木箱 	T
采取 的 是 欺诈 的 手段 	M
江 泽民 总书记 视察 深圳 时 指出 	M
是 在 昨日 举行 的 中 日 韩 都市 计划 学会 国际 学术 交流 研讨会 中 	T
一个 重要 原因 就是 广大 消费者 还 被 蒙在鼓里 	M
而 这 种 球路 对 昨天 上阵 的 九 名 打者 	T
型 具有 公正 无私 的 操守 和 懂得 照顾 旁人 的 长兄 气质 	T
否则 我 一定 会 加派 人手 去 救 地球 的 	T
友讯 科技 为 协助 政府 或 企业 用户 扩大 原有 乙太 网路 的 使用 满意度 	T
亚运村 副 村长 林寿 先生 宣布 	M
左训 原有 的 两 位 防护员 	T
注意 向 科技 转化 方面 倾斜 	M
消费者 还 会 怀疑 商品 的 品质 不 够 好 	T
苏联 已 开始 单方面 地 从 东欧 撤军 	M
由于 参加 者 只有 十九 人 参加 	T
深圳 的 绝大多数 党员 和 干部 一直 保持 和 发扬 了 廉洁奉公 的 作风 	M
于是 他 只好 想出 找 大陆 百 花 影帝 姜文 来 台 拍戏 的 噱头 	T
海湾 在 为 全世界 的 军人 上课 	M
在 大桥 建成 的 前 一个 月 倒下 了 	M
２／３ 的 设备 落后 于 全国 先进 水平 	M
必须 坚持 党 的 基本 路线 	M
系 由 台湾 银行 研究室 出版 的 文丛 标点本 中 挑选出 涵盖 前 清 皇朝 实录 选辑 奏议 纪事 等 档案 	T
唐 启文 是 配套 压力 管道 施工 的 技术 负责人 	M
准备 在 明年 十月 中旬 暂时 休馆 	T
购 票 后 三 分钟 之内 车子 会 到站 	T
最 理想 的 场地 则 是 邻近 工作 地点 	T
 庞贝 的 印象 多 年 来 一直 在 我 心 里 浮动 	T
搞好 环境 建设 和 环境 的 综合 整治 	M
乳牙 部分 男生 有 三 颗 蛀牙 	T
今年 女学会 的 工作 重点 则 是 推出 台湾 妇女 白皮书 	T
最后 敲定 了 雅典娜 －－－－ 主宰 智慧 艺术 和 美 的 女神 	T
医治 仓 梗阻 要 把 大 环境 企业 内因 外因 放在 一起 	M
厂里 又 投资 ３万 元 购置 了 两 台 质量 检测 仪器 	M
这 有利于 增进 特区 的 凝聚力 	M
我歌 公司 北市 重庆北路 三段 二五号 	T
像 我们 这样 不 认识 人 的 每天 就 对付 个 工钱 	M
这 ５ 名 记者 的 报道 极度 夸张 了 该 地区 的 形势 	M
许多 极端 民族主义 组织 的 一些 头头 已 被 拘捕 	M
拉 过 话筒 通报 起 全区 计划生育 最新 情况 	M
今后 再也 不 想 看到 这 一 概念 出现 	M
相当于 一个 中型 水库 的 容 水量 	M
有 一些 城市 首 次 对 黑人 开放 某些 公共场所 	M
正是 为了 避开 杭州市 内 交通 拥挤 地段 	M
主要 经济 指标 创 企业 历史 上 最高 水平 	M
对外 开展 技术 服务 劳务 服务 和 工程 承包 	M
而 挂 在 台大 福华 餐厅 及 侨光堂 对面 的 布条 则 被 人 拿走 	T
会谈 终于 在 记者 的 焦急 等待 中 结束 	M
５ 个 班 的 学生 只好 在 操场 上 露天 上课 	M
要 钱 树 变成 了 摇钱树 辽宁 低产 果园 改造 获 大面积 成功 	M
还 就 一些 常见 多发 或 危害 严重 的 疾病 如 智力 低下 耳聋 盲 等 进行 了 病因 学 和 遗传学 分析 	M
呼和浩特 汽车站 候车 大厅 里 秩序井然 	M
但 它 主要 是 应用 于 疾病 晚期 的 病人 	T
李登辉 这 个 总统 也 未免 太多 辛酸 委屈 了 堂堂 一 国 之 尊 	T
记者 提及 女 劳模 钱 小平 	M
台湾 的 河南 梆子 与 大陆 的 人才济济 的 情况 不能 比 	T
美军 发现 有 不明 飞行物 朝 利雅得 飞来 	M
与会 专家 学者 在 听取 捷运 及 交通 相关 官员 说明 目前 各 项 捷运 车站 接驳 设施 规画 布设 情形 后 	T
但 到底 助教 在 学校 里 扮演 什么 样 的 角色 	T
这些 都 是 使 篮球 成绩单 呈现 小时了了 	T
其中 开支 增加 的 项目 有 宇航 外援 环保 扫毒 学前教育 和 科技 研究 等 	M
在 日 苏 关系 出现 松动 之前 	M
他们 敲门 请来 了 还 未 上班 的 街道 居委会 相 交通 市容 整顿 办公室 同志 	M
此 一 因素 也 促使 未来 几 天 盘面 无法 太 乐观 的 重要 原因 	T
要 提高 业余 训练 和 学校 体育 水平 	M
若要 喝 冰 的 饮料 只有 白酒 适合 	T
看来 这 位 从事 幼教 的 母亲 	T
到 台湾 已 四 年 了 	T
才 发现 唐语谦 三 字 竟 有 四 个 口 	T
以 ５ Ｍｘ ５ Ｍ 的 地震 模拟 振动台 最 具 特色 	T
十七 岁 因 在 校 内 顶撞 教官 宋国升 男 	T
衡东县 教委 在 体委 配合 下 	M
新加坡 也 鼓励 学校 开 多元 的 课外 活动 	T
国内 现有 保险 合作社 与 相互 保险 的 精神 雷同 	T
而 于 昨日 下午 三时 安全 地 由 我 海军 舰队 接送 返航 	T
由 奇特旺 上 南边 的 公路 	T
成立 伊始 的 深圳 祥 云 国货 精品 商场 庄严 地 宣告 	M
这 两 天 却 分别 在 芬兰 和 瑞典 捧回 八 个 分龄 篮赛 冠军杯 四 座 亚军杯 	T
没有 看到 他 日夜 盼望 的 大桥 通车 	M
所以 婚姻 制度 对 一 个 社会 而 言 是 需要 的 	T
目前 校长 人选 的 诞生 方式 	T
特地 将 日本 男篮 送到 美国 加州 州大 进行 改造 	T
不要 画地自限 的 结交 同事 朋友 	T
或 以 乐团 的 形式 表演 	T
除了 指 父母 对 子女 无微不致 的 关爱 以外 	T
当 我 在 繁忙 的 街道 上 购买 水果 等 民生 用品 时 	T
距离 下 一 次 常委会 也 就是 １ 个 多 月 的 时间 	M
让 狗 的 活动 范围 也 更 具有 弹性 	T
他 请 中国 大使 转达 他 对 杨 主席 以及 其他 中国 领导人 的 问候 	M
大概 也 只 能 制造 另 一 批 撒 豆 成 兵 的 妖魔鬼怪 吧 	T
在 当前 大力 加强 完善 和 提高 监测 工作 	M
下 周 才 有 机会 真正 突破 颈线 压力 二十五 元 	T
虽然 疾病 早期 的 病理 变化 并 未 伴 著 功能性 的 缺失 	T
在 台湾 拥有 高知名度 并 占有 良好 的 市场 以及 口碑 	T
否则 别人 会 有 搞 小 圈圈 的 质疑 	T
赫兹 目前 的 十三 个 营业所 人员 正 进行 清理 工作 	T
原先 处于 失控 状态 的 苏联 伊朗 边界 也 在 地方 党政 机构 参预 下 	M
才 可以 观察到 许多 丰富 的 生态 行为 	T
为 鼓励 小朋友 积极 参与 国语科 家庭 作业 并 达到 提升 语文 程度 的 教育 目标 	T
放弃 以 一 个 法人 的 眼睛 来 看 台湾 	T
陆游 只 能 将 心 中 的 眷恋 忿懑 写 在 沈园 的 墙 上 	T
及 年 底 选举 又 增 许多 变数 	T
会 损害 １０ 年 来 广州 改革 开放 的 成果 	M
银耳 香菇 也 开始 进入 寻常 百姓家 	M
在 工棚 里 找到 了 唐 启文 	M
我们 是 今年 ５月份 到 这 的 	M
所以 抢孤 就 变成 是 项 较劲 夺标 的 民俗 体育 	T
全 国 田径 协会 秘书长 江界山 昨天 观看 国内 别开生面 的 室 内 田径赛 	T
引进 的 数千万 元 的 水力 活塞 泵 价值 ２００ 余 万 美元 的 进口 录 井 仪 耗资 ２０００ 多 万 美元 的 电厂 设备 躺 在 仓库 睡 大 觉 	M
在场 的 同志 感动 得 眼睛 湿润 了 	M
一 位 年 仅 ３７ 岁 的 军人 	M
整个 国民经济 继续 朝着 好 的 方向 发展 	M
满载 活蹦乱跳 河豚 鱼 的 １４２３ 号 船 	M
华新 等 股 及 金融股 主力 出货 明显 	T
优酪乳 或许 能 防止 癌症 的 发生 	T
辽宁省 正在 组织 经济界 企业界 人士 探讨 东北 现象 的 深 层次 根源 	M
还 有 尽可能 避免 精神性 的 刺激 反应 	T
南韩 政府 原本 甚至 在 洲际 饭店 保留 了 三百 具 特 设 电话 	T
抢劫 全部 现金 后 夺 门 逃窜 	M
满满 卅六 坪 大 的 屋子 里 全部 塞满 书 和 收藏品 	T
我 想 把 只是 近 黄昏 改为 晚霞 放 光辉 	M
记者 在 商场 访问 了 不同 人士 	M
东海 校园 规划 委员会 已 决定 请 原 设计人 到校 作 公开 说明 	T
是 希望 观光业 的 发展 能 尊重 社区 居民 的 主权 	T
驾车 猎游 者 皆 必须 驾驶 厢型车 或 巴士 	T
若 再 加上 国内 政府 目前 态度 之 保守 	T
所到之处 都 受到 热情 隆重 的 欢迎 	M
洛杉矶 加州 大学 的 预测 报告 一向 颇 受 各 方 重视 	T
由于 地面 的 保 水 能力 下降 	T
他们 说 有的 同学 已 有 十 来 天 时间 不 洗 脸 	M
这 是 一个 重要 的 马克思主义 的 文件 	M
只有 修订 目前 法令 中 对 妇女 不 公平 的 条文 	T
则 可 由 富有 经验 的 巡守员 负责 向导 	T
美国 将 把 从 南朝鲜 撤军 的 人数 降 到 最低 限度 	M
省长 岳歧峰 是 这么 分析 的 	M
各种 野生 动植物 在 大量 消失 	M
非台大 医学院 的 学生 也 可以 使用 	T
如果 通过 申请人 必须 尽快 组成 学生 申诉 评议 委员会 	T
但 多 位 成员 均 为 议会 中 的 反对派 	T
准许 苏联 不必 销毁 多 种 教练机 及 双 功能 攻击 及 支援 直升机 	T
使 整个 城市 生态 系统 失去 平衡 	M
下 学期 他们 打算 再 做 一 次 教学 评鉴 	T
随着 一个 个 困难 被 克服 	M
但 经济区 的 建立 从 长远 看 符合 两 大 经济 集团 的 利益 	M
满足 了 特定 消费者 群 的 特殊 心理 需求 	M
三十几 个 学生 团体 九日 发表 联合 声明 	T
机电 类股 似乎 缺乏 接续 轮 涨 脉动 的 力道 	T
对 公司 与 个人 的 生产力 均 有 帮助 	T
参赛 的 车种 都 是 经过 改装 的 市售 量产 车种 	T
１９８９年 已 生产 原油 ３０万 吨 	M
在 中共 暗示 它 将 在 联合国 授权 动武 决议案 中 弃权 之后 	T
便 多 一 种 创作 风格 及 发挥 空间 	T
也 就 是 这样 一 步 一 步 的 走过来 	T
芮氏 地震仪 上 记录 了 ５ 级 的 地震 	T
冀东 石油 勘探 开发 公司 成立 	M
另 有 七 家 正 计划 进军 台湾 	T
这 一切 便 构成 了 我们 广场 上 大学生 的 生活 图画 	M
人们 读 后 自然 要 大 呼 上当 	M
在在 均 属于 特定 公司 专属 的 知识 	T
确保 每 个 学生 皆 能 遵循 	T
体育 新闻 网球 记者 林珣 台北 报导 玖顺杯 国际 网球 卫星赛 廿六日 进行 第二 天 会内赛 	T
学生 有 权 决定 他们 需要 怎样 的 教育 环境 	T
而 其 父亲 蒋介石 及 戴传贤 之 子 戴安国 先生 	T
这 下 连长 别 想 进步 了 	M
对 这个 问题 就是 要 严肃 认真 	M
可 与 府会 联手 清除 弊端 	T
管 它 要 琢 还是 要 磨 	T
把 天安门 广场 作为 根据地 	M
假如 神州 大地 所 指 的 不只 是 锦绣 中华 而是 万物之灵 所 居住 的 地球 	T
这些 情况 对 南方 国家 提出 了 新 的 挑战 	M
但 最 好 的 解决 办法 可能 是 选定 内部 某 个 区域 	T
海水 淡化 工厂 与 发电厂 关闭 即便 只是 短期 的 关闭 其 成效 都 要 比 伊拉克 对 敌人 发动 的 孤立 恐怖 行动 为 佳 	T
有时 他 很 想 报警 处理 	T
政府 威信 受到 严重 挑战 	M
竟然 把 责任 推 得 一干二净 	T
他 的 一生 是 短暂 的 	M
８时 多 门口 已 排 起 了 长龙 	M
自称 对 工作 变动性 极 低 的 林汉章 一 做 就 是 十 年 	T
鉴于 跳蚤 生长 特性 系 孳生 于 地下室 阴暗 空间 	T
欧洲 共同体 和 欧洲 自由 贸易 联盟 关于 建立 欧洲 经济区 的 新 一 轮 高级 谈判 日前 在 布鲁塞尔 结束 	M
对 古版 画 书 兴趣 浓厚 的 袁芳荣 每 星期 都 要 到 百城堂 报到 	T
一 是 出于 客观 形势 所 迫 	M
我 像 站 在 云 里 天上 一样 那么 高 	M
第二 批 １５ 辆 汽车 也 将 于 近期 交货 	M
若 再 有 改变 校园 景观 的 工程 	T
因此 它 特别 需要 大量 资金 	M
广州 地区 集结 了 一 批 中央 省属 的 科研 机构 和 高等院校 	M
国家 和 企业 无力 向 每户 职工 家庭 无偿 提供 一 套 住房 	M
捷 苏 两 队 都 是 本国 联赛 多次 冠军 获得者 	M
下 半 周 则 注意 冲关 时 的 主力股 	T
这 就 给 执政党 实施 分化瓦解 	M
但 另 一 家 大型 租 车 公司 中国 联合 公司 一 位 自称 可以 作主 的 张 先生 不 愿 接受 外界 询问 	T
所以 三军 剧团 对于 未来 失去 表演 地盘 的 何去何从 	T
这 是 百城堂 店名 的 由来 	T
这 句 话 的 幕后 另 有 文章 	T
两 项 投资 计划 所在地 位于 台南县 七股乡 西侧 台盐 总厂 盐场 第三区 的 土地 	T
当然 不 排除 中共 武力 攻 台 的 可能 	T
从而 使 居民 住房 问题 长期 难以 解决 	M
启动 狗 身 上 接收器 的 电流 加以 电击 	T
提高 卫生 教育 及 充实 营养 常识 	T
而今 却 因 销售 乏 术 	M
一 张 没 写完 的 纸条 	T
这 位 去年 在 纽约 得到 亚洲 杰出 艺人奖 的 全能生 	T
王 主任 一路 记起 滑坡 中间 的 一 段 惨剧 	T
同时 把 国家 企业 的 责任 放在 一个 与 它们 能力 相 适应 的 地位 	M
在 资金 投放 上 予以 优先 保证 	M
用 俄语 小声 对 他 的 同伴 说 	M
吴 爷爷 才 如愿 完全 致力 于 创作 	T
１９９０年 又 获 全国 轻型 卡车 质量 检测 第二 名 	M
加强 舆论 宣传 特别 是 理论 先行 	M
难道 非 迷信 不 可 吗 	T
目前 淡水 汐止 也 久 旱 未 雨 	T
苏联 虽然 非常 希望 获得 日本 的 经济 和 技术 援助 	M
历史 语言 研究所 聘 王泛森 先生 为 副所长 	T
山东省 的 改革 开放 能够 持续 发展 	M
几亿 曾经 身 历 那 场 灾难 的 中国人 至今 创痛 在 心 	T
要 实现 这 一 目标 是 相当 艰巨 的 	M
而 要 择 其 善 者 而 从 之 	M
基隆市 已 六十九 天 久 旱 无 雨 	T
足迹 踏遍 台湾 三 大 山系 中央 雪山 及 玉山 山脉 	T
内容 并 不 涉 敏感 的 政治 问题 	T
进行 国内 行销 通路网 建立 计划 	T
特别 行政区 公务员 必须 由 香港 的 永久性 居民 担任 	M
是 福利型 住房 向 住房 商品化 的 起步 和 过渡 	M
坚定不移 地 为 社会主义 事业 奋斗 的 战士 	M
其中 一 尊 北魏 太和 元年 的 释迦牟尼 佛像 	T
她 也 知道 制度 和 福利 方面 的 缺失 	T
上海市 演出 公司 联合 苏州 无锡 常州 南通 嘉兴 杭州 等 市 的 兄弟 公司 	M
兄弟队 老板 洪腾胜 必须 在 今天 的 职棒 领队 例行 会 中 	T
但 这 并 不 影响 两 国 正常 关系 的 发展 	M
将 是 这 场 战争 的 第二 阶段 	M
由于 许多 科目 因为 甲 乙班 老师 不同 	T
手里 握 着 一 束 鲜花 	M
三 公务员 之 义务 依 公务员 服务 法 之 规定 	T
工程 科技 包括 机械 化工 电子 电机 材料 食品 资讯 土木 环工 等 八 类 	T
这次 选举 自民党 面临 的 不利 因素 很多 	M
无法 完全 杜绝 坊间 部份 会计师 替 公司 做 假 帐 及 不实 财务 签证 的 风气 	T
在 西德 总理 ２月 ７日 提出 进行 两 德 货币 联盟 协商 后 的 第二 天 	M
法律 实在 是 不在乎 你 是否 招供 的 	M
要 下决心 改 分散 治理 为 集中 治理 	M
海湾 大道 仍然 是 望 不到 首尾 的 车 龙 和 人流 	M
随便 人 是 无法 亲沐 容颜 	T
其 可 观测 较 大 范围 之 地表 	T
要 使得 我们 工人 的 实际 收入 每年 总是 还要 有所 改变 	M
且 同 一 科目 不同 班级 之 学生 	T
明人 已经 只 能 按 谱 填词 	T
在 经济 建设 和 社会 发展 服务 中 也 起 着 重要 作用 	M
著重 思想 情感 德性 灵性 与 人生观 的 抒发 	T
而 师生 由于 相处 时间 多 	T
长年 在 左营 排练 和 教学 的 王海玲 指出 	T
当 学生 离开 学校 时 能 找到 工作 	T
职工 们 议论 较 多 反响 较 大 的 一个 话题 	M
这些 企业 大部分 未能 达到 批量 要求 和 投入 产出 比 的 要求 	M
在 台北 市立 网球场 将 继续 进行 第三 天 会内赛 赛程 	T
我 看 就 连 家门口 这块 地盘 都 得 叫 人家 占领 了 	M
２３ 岁 的 李 庆文 ６ 年 前 考入 清华大学 时 	M
深圳 十 多年 经济 调整 发展 的 历程 	M
大锅饭 所 鼓励 的 是 懒汉 思想 和 懒汉 行为 	M
因此 我们 可以 简单 归纳 地 说 	T
人力 问题 却 一直 无法 解决 	T
赫斯特 发现 受 过 教育 训练 的 员工 	T
事实 上 是 到 现在 我们 仍 在 追求 的 	T
但 做 学问 要 心无旁骛 没有 干扰 	T
怎样 实现 对 发展中国家 的 资金 援助 和 技术 转让 等 一 系列 问题 进行 了 深入 的 讨论 	M
将 他 打入 黑暗 的 地狱 	T
小西园 荣获 教育部 第一 届 薪传奖 戏曲类 团体奖 	T
课征 五 种 不同 的 公卖 利益 	T
在 去年 夏天 的 参议院 定期 选举 中 	M
公车 家族 和 和气 的 山羊 家族 漂亮 小姐 的 雨伞 奇幻 世界 的 好 怪物 	T
老板 们 在 这样 的 环境 里 弄 潮 	M
中国 共产党 以 它 一贯 对 国家 和 民族 的 前途 高度 负责 的 态度 	M
长虹 厂 的 一度 积压 电视机 达 一二十万 台 	M
连长 的 一番话 唤起 了 这些 战士 自尊 自强 的 精神 	M
那 都 是 千千万万 人 一起 劳动 的 成果 啊 	M
我 到 美国 去 的 时候 	M
商店 的 台阶 上 站 满 了 观望 的 人 	M
期间 所务 由 该 所 行为 研究 组 组主任 章英华 先生 代理 	T
过去 只要 有 旧 屋 拆建 	T
充分 利用 了 世界 电子 技术 的 成就 	M
感动 得 不知 说 什么 好 	M
以色列 欲 使 约旦河 西岸 和 加沙 地带 人口 比例 发生 变化 	M
更 连 优点 与 功绩 也 不 肯 随口 奉告 	T
优越 的 条件 滋生 了 他们 懒散 骄 逸 的 毛病 	M
有些 落笔 处 似 是 务实 	M
坚决 按 条令 给予 了 处分 	M
是 由 绿色 植物 吸收 以 进行 光合作用 	T
开始 了 新 的 冒险 生涯 	M
传闻 能 庇护 政坛 人物 步步高升 	T
缴获 的 这 件 玉璧 是 去年 ８月 余杭 县 安溪 乡 一 姓 李 的 农民 掘 地 时 发现 的 	M
拿 长虹 彩电 作 奖品 开展 有 奖 储蓄 活动 	M
政府 官员 事 前 也 在 北韩 总理 及 其 随员 房间 里 搞 了 好几 天 	T
后 半 部 则 是 仓库 	T
报名 资料 请 挂号 邮寄 台北 市政府 劳工 育乐 中心 	T
新 推出 的 １７３ 升 大 冷冻室 冰箱 也 颇 受 欢迎 	M
看到 他 有些 激动 的 样子 	M
过去 的 语文 教育 方式 过于 片面 呆板 	T
当场 决定 在 一 星期 后 的 ３月 ２日 和 ３日 访问 美国 	M
里面 也 装饰 得 十分 气派 	M
因 陆游 的 母亲 不 喜欢 她 	T
询 价 宜 到 案子 结案 	T
我 跟 儿童 乐园 里 的 碰碰车 是 不 是 长 得 很 像 呢 	T
资金 利税 率 下降 ２．８８ 个 百分点 	M
周肇隆 形容 网际网路 的 商机 尚未 真正 成熟 	T
许绩胜 目前 拥有 场 内 男子 一万 公尺 的 廿九 分 四十八 秒 五 全 国 纪录 	T
且 住在 那里 的 老师 很多 来自 欧洲 	T
或 直接 采用 审查 方式 选取 学生 	T
但 谢 艾卜 校长 还是 满怀信心 地 说 	M
公司 专质性 知识 的 蓄积 需要 时间 年资 的 历练 	T
台上 的 厂长 书记 们 心里 也 有 一 本 帐 	M
江 泽民 解开 毛巾 擦 了 擦 汗 	M
且不说 在 中央 省级 的 广播 电视 报纸 上 	M
一 位 女 大学生 营业员 打开 电视 录像 的 卡拉ＯＫ机 	M
如 将 球 踢过 球门 横杆 	T
美国 发动 政治 攻势 于 前 	M
电脑 旁 也 有 使用 手册 	T
位于 交通路 的 武汉 工具 书店 开业 	M
都 有 参与 国际 环境 保护 与 发展 事务 的 权力 	M
预算 中 对 民用 项目 的 削减 计划 降低 资本 收益 税 的 计划 家庭 储蓄 账户 计划 等 都 已经 引起 了 很 大 争议 	M
李 景春 老汉 听说 老王 要 去 孙 家炉 上 技术课 	M
三 家 竞标 厂商 在 国外 皆 有 承接 此 类 计划 的 经验 	T
新华社 北京 ９月 １４日 电 记者 陆 国元 张 伟弟 周 正平 记者 最近 在 华东 沿海 对 百 家 三资 企业 进行 的 一 次 调查 表明 	M
其中 还有 ０．１５亿 元 是 靠 免税 还 的 	M
以 解决 渥太华 会议 遗留 下来 的 问题 	M
原先 拒绝 让 德军 再度 涉足 苏联 领土 	T
你 怎么 能 有 故人 多 处 亦 吾 乡 的 感觉 呢 	M
广州 东山口 农林 电影院 附近 响起 一阵 抢 钱 啦 	M
他们 开始 探求 新 的 出路 	M
保固 维修 工作 也 相当 重要 	T
加上 合理 主义 的 型 判断力 	T
在 经济 和 科技 领域 面临 着 日本 和 欧共体 的 严峻 挑战 	M
北京市 提出 了 ７ 条 船 的 改革 措施 	M
台铁 除 上 下 通勤 列车 照常 开行 外 	T
兹 对 欧洲 传统 武力 谈判 作 纵切面 与 横切面 的 回顾 	T
而 学生 来 学 的 不 只 是 知识 	T
由 国际 特赦 组织 台湾 分会 主办 的 女性 与 人权 座谈会 	T
１９８８年 他们 在 出口 冷冻 鱼虾 时 发现 	M
剧场 团长 刘静敏 特地 赴 日 邀请 了 日本 狂言 名 帅 野村耕介 来 台视 授课 	T
两 家 在 西单 街头 还 得 继续 较劲 	M
这样 可 增加 他们 对 学校 的 参与感 和 本身 自主性 	T
质询 环保局 要求 尽速 前往 消毒 	T
依循 过去 国内 重大 科技 计划 发展 经验 	T
一 位 干部 模样 的 人 对 一 位 正在 清扫 的 工人 说 	M
叶 洪祥 就 这样 由 母亲 的 书包 里 盗走 了 后来 是 他 犯罪 证据 的 支票 	M
那些 没 能 上岸 迎 圣火 的 台湾 渔民 	M
摘下 电脑 高科技 的 面纱 之后 它 仅只 是 一 个 高速 计算 工具 	T
能 不能 改 以往 之 开放 为 封闭 	M
自民党 能 在 最近 的 大选 中 获胜 	M
于 三月 二十二日 至 四月 十五日 	T
且 居民 每 日 出入 安全 都 将 受到 影响 	T
所有 的 营区 均 有 清楚 及 详尽 的 游园 规定 	T
此 役 巨人队 分别 由 后藤孝次 	T
由 这 一 段 话 可以 知道 	T
此 项 富 前瞻性 的 科技 发展 合作 	T
又 是 一 个 好 例 	T
大 塔 前 的 埃米尔宫 四 门 洞开 	M
且 缺乏 长 线 的 支撑 下 	T
这 并 不 像 一般 训练 	T
阿拉伯 国家 正在 酝酿 召开 一 次 阿拉伯 特别 首脑 会议 	M
谁 肯 花钱 去 买 那 白水 水 	M
美国 政府 决定 为 军火 出口 提供 信贷 保证 将 会 促进 美国 对 这个 地区 的 武器 出口 	M
一个 小伙子 在 向 同伴儿 贷款 	M
领事馆 人员 表示 已 发给 医护 人员 了 	T
才 给 老汉 解 了 围 	M
黄如弟 ８０年 ０９月 ０９日 星期六 记者 赵雅芬 台北 报导 台湾 的 表演 团体 	T
我 的 脸上 也 没有 离开 过 笑容 	M
谁知 此事 被 刘 晋峰 吴 振 知道 了 	M
那些 一向 以 坚固 耐久 不 招风 惹 眼 为 守则 的 人们 也 有滋有味 地 打扮 起来 	M
和 资本主义 发达国家 的 同 类型 企业 相比 	M
还 包括 附近 蒋公 铜像 的 大理石 底座 	T
稳定 是 大局 之 所 系 	M
价格 和 价值 等同 是 其 外在 形式 	M
以 打 草 不 惊 蛇 鸭子 划 水 的 方式 解决 问题 	T
兄弟 姊妹 之间 也 要 相亲相爱 	T
花莲讯 花莲县 牙医师 公会 理事长 徐正隆 表示 	T
这 只是 南非 当局 向 正确 方向 迈出 的 第一 步 	M
当前 农业 出现 的 转机 是 一 种 阶段性 的 转换 	M
也 极 有 可能 在 明年 正式 开工 	T
除了 面对 国内 环保 和 生态 保育 人士 的 反对 压力 外 	T
也 是 台北 时间 二十三日 午夜 	T
捷克斯洛伐克 目前 也 正在 同 苏联 就 撤走 ８万 苏军 进行 谈判 	M
美 苏 直接 间接 参与 的 局部 战争 和 武装 冲突 不断 发生 	M
我市 各界 掀起 了 一个 学 雷 锋 的 热潮 	M
此 次 的 新 书 发表会 在 诚品 书店 的 敦南 艺文 空间 举行 	T
北京 ９１ 特价 书市 第一 天 	M
主 随 客 便 是 也 	M
他 是 为 捍卫 国家 独立 主权 和 统一 而 献身 的 	M
曾庆瑜 是 个 不可多得 的 全才 艺人 	T
也 有的是 陕北 高原 的 女 学生 	M
这 ３ 个 文件 并未 如期 签署 	M
争 保护 要 计划 有 门 	M
我 又 给 台湾 通 了 电话 	M
１９８９年 全省 共 收购 合同 定购粮 和 议价粮 ３５ 多 亿 公斤 	M
这项 成果 是 由 杭州市 第二 人民 医院 和 杭州市 心血管 病 研究所 浙江 医科 大学 等 ７ 个 单位 的 科技 人员 	M
今后 不再 选用 贵 厂 产品 	M
辽宁 一家 企业 就 因 产品 质量 问题 被 老 用户 明确 告 之 	M
将 公债 发行 事宜 报 行政院 核定 后 	T
电话 这边 问 展览 情况 如何 	T
还 想 干 一番 大 事业 	M
将来 长出来 的 牙齿 就 会 不 整齐 	T
常 以 支配性 的 角度 要求 其他 单位 配合 	T
我 忽然 想 把 他 的 这 番 话 告诉 他 的 父母 	M
而 成本 将 由 大众 吸收 	T
全 靠 老焦 当年 领 着 大伙 种树 治沙 	M
卫生局 建议 民众 避免 购买 散装 冰 	T
是 出自 方 才 学会 唯一 的 五 个 字 的 庭硕 之 手 吗 	T
杨嫌 向 警方 坦承 元月 五日 伙同 在逃 嫌犯 赖建荣 男 	T
对 大多数 癌症 患者 的 存活率 并 没有 显著 改善 	T
他 抬头 一 看 倒水 的 也 是 一 位 老人 	M
飞马 豫剧队 的 培养 人才 工作 也 开始 看到 成绩 	T
前往 美浓镇 中兴路 一段 廿二号 宋 教官 住处 	T
他们 于 去年 １２月 １８日 第一 次 为 胎儿 做 心脏 手术 	M
也 要 呼吁 周围 的 亲人 及 朋友 	T
更 会 针对 全球化 与 企业 再 造 等 管 三 管理 训练 	T
南非 当局 对 广大 黑人 的 血腥 统治 和 镇压 激起 了 南非 人民 日益 强烈 的 反抗 	M
听 父亲 说 当时 北京 市民 为 北平 一 名 甚 反感 	T
集团 居住区 法 居民 登记 法 土地法 独立 家园 制 等 种族歧视 法令 均 未 废除 	M
勤政 乃 廉政 题 中 应有 之 义 	M
看 一百 本 就 完全 懂 了 	T
父亲 双手 颤抖 的 很 厉害 	T
这 种 人 常 是 众人 注目 的 焦点 	T
同时 电信局 亦 将 在 明年 一月 前 	T
职工 与 企业 国家 共命运 的 热流 遍及 四十 里 钢城 	M
一 呆 就是 近 三十 年 	M
至今 共 举行 五 次 建造 工程 会议 	T
而是 重新 训练 他们 读 写 数学 三 方面 的 能力 	T
半 盒 半 盒 的 米饭 就 这样 被 扔掉 了 	M
谴责 英国 的 这 一 错误 行为 	M
但是 普雷 也 不 是 没有 隐忧 	T
她 形容 自己 是 以 沈重 的 心情 购买 典藏 	T
两 位 副 市长 准时 赶到 	M
妳 母亲 离婚 并 不 可耻 	T
高脂血症 胆固醇 中性 脂肪 磷 脂肪 等 血液 中 脂肪 成份 异常 地 增加 抽烟 高血压 肥胖 糖尿病 痛风 高尿酸血症 	T
主要 表现 在 以下 两 方面 	M
真 有 说 不 出 的 亲切 和 欢乐 	M
大家 就 会 以为 主管 们 说 这 课 不 重要 	T
却 写 成 淀粉 和 粮食 等等 	M
更 在于 错 把 它 当作 保持 稳定 和 反对 分配 不公 的 思想 武器 	M
则 视 当时 情况 再 作 决定 	T
把 它 放在 重要 的 战略 地位 	M
此间 的 交通警 能 满足 他们 的 需要 吗 	M
是 提供 男性 对 美 的 观点 来 指导 女性 化妆 	T
在 依靠 科技 推动 经济 发展 方面 	M
多 位 专家 学者 抨击 相关 设施 规划 不足 	T
诸如 中东 和平 进程 两 伊 争端 黎巴嫩 危机 及 苏联 犹太 移民 等 问题 	M
业者 并 特别 标榜 这 种 月饼 由于 用料 特殊 	T
由于 报名 时间 约 在 七 八月 间 	T
即 能 有效 地 克服 鞋跟 磨 偏 的 老 难题 	M
其中 几乎 每个 学科 都 与 计算机 技术 有 缘分 	M
对 今天 的 形势 一 片 大好 	T
抱 起 浑身 是 血 昏倒 在 地 的 任 志庆 送往 医院 救治 的 人们 	M
它 会 介绍 资讯 的 有关 知识 	T
每 组 分别 甄选出 冠 亚 季军 各 乙 份 及 优胜 各 三 名 	T
地面 无法 借由 水分 蒸发 的 冷却 作用 来 调节 气候 	T
我 在 广场 找到 了 穿 绿色 Ｔ恤 的 矮个子 	M
对于 重大 决策 应该 作 更多 的 脑力 激荡 	T
修业 期间 与 国内 同 级 同 类 学校 规定 相当 	T
剧场 持续 了 近 两 年 的 计划 	T
我们 再 从 资金 的 角度 来看 	M
只是 我们 在 参加 甄试 前 	T
希望 建立 一 个 新 的 区域 安全 体系 	T
也 预订 翻修 十八 九 年 未 更新 的 座椅 	T
张 小姐 直 拉 我 袖子 示意 叫 我 快点 走 别 搭理 	T
但 日前 亦 指示 如 有 需要 	T
由 学生会 意见 信箱 的 负责人 黄书健 侯钧贺 整理 意见 	T
当 第１４ 笔 ５０万 元 １９８６年 国库券 成交 时 	M
没有 信心 或 非常 没有 信心 的 只 有 百分之十三点六 	T
更 重要 的 是 政权 在 我们 手里 	M
形成 重点 科技 或 共识 后 	T
前者 导源 于 切身 之 痛 	T
呼市 地区 积雪 没 了 脚腕子 	M
你 目睹 过 这样 的 场面 吗 	M
允许 流动 的 人才 管理 模式 	M
还 展示 了 １８０ 多种 专利 待 转让 	M
在 明楼 的 西侧 又 开 了 第二 条 探道 	T
爱 乡 活动 是 北原会 最 重要 凝聚 成员 向心力 的 活动 	T
专门 销售 首饰 艺品 滤水器 等 街坊 便利商店 所 不 卖 的 物品 图 为 总经理 张志贤 	T
彼此 都 感动 于 恍 同 隔世 的 奇遇 	T
而 铜陵 仅 有 １７４４ 元 	M
聚集 在 北京 图书馆 门前 的 书迷 队伍 格外 壮观 	M
另外 今天 还 将 讨论 有关 国际 体育 事务 人才 的 第二 梯次 培训 工作 	T
老人 是 硬撑 着 病 弱 的 身子 来 和 儿子 圆 月 的 	M
就 不能不 动 到 某些 摊摊 	M
反而 是 每 家 公司 独异 的 情境 	T
以 推翻 无产阶级 专政 的 政权 和 社会主义 制度 为 目的 的 	M
旅游局 已 聘请 顾问 公司 著手 评估 	T
内心 却 如 槛 中 之 猛兽 	T
几 个 负责人 边 走边 议论 说 	M
正 如 伊利诺州 读写 能力 资源 发展 委员会 ＩＬＲＤＣ 	T
如 中华书局 世界 书局 大东 书局 湘芬 书局 等等 	M
问 林汉章 究竟 有 多少 藏书 	T
今年 一 至 九月 工业 产品 总 出口值 四百九十二亿 美元 	T
与其 不死不活 等待 竞争 法则 自然 淘汰 	M
她 对 跋扈 老师 的 毫不 客气 	T
人 长 得 虽然 很 漂亮 	T
那 可 得 小心 惹来 一 顿 臭骂 	T
０ 获得 首场 比赛 的 胜利 	M
只好 在 狭小 的 国内 市场 你 夺 我 抢 	M
这 是 金星 表面 上 红色 的 大 平原 	T
现在 则 是 以 每 一百 公撮 四十 以下 无 冰 饮料 每 一百 公撮 一百 以下 加 冰 冷饮 标准 来 检验 	T
保障 了 几十 年 的 和平 建设 	M
此时 却 传出 该 公司 以 不实 之 广告 蒙骗 消费者 	T
东 西 两 大 博物馆 的 世纪 交会 	T
得奖 作品 也 就 少 了 	T
其中 更 有 人 认为 此 次 战争 将 有 可能 引发 为 宗教 意味 浓厚 的 战争 	T
在 两 个 月 的 时间 里 	M
过分 强调 词别 是 一 家 	T
可以 杀菌 又 可以 兼顾 环境 保护 	T
都会 写下 他们 的 功绩 和 创举 的 	M
仅 有 定陵 对 外 开放 	T
他 想 到 日本 学 音乐 	T
望 着 一个 个 女排 姑娘 	M
目前 当务之急 是 改革 国际 金融 货币 和 贸易 体系 	M
是 故宫 最 得意 的 购藏 之 一 	T
整 个 计划 最 大 的 用意 是 因为 互动 电视 的 系统 成形 不可能 由 任何 单一 厂商 甚至 单一 产业 可以 独力 完成 	T
还 称得上 是 共产党 的 干部 吗 	M
当然 也 有 缓步 而 处变不惊 者 	T
或许 你 还是 稀饭 馒头 夹 咸菜 	M
除 将 先行 开凿 其中 一 口 未 遭 民众 反对 的 新 井 外 	T
也 算是 尽 一点 我 的 职责 吧 	M
立即 向 市警 一 分局 后甲 派出所 报案 	T
但 转化率 却 大大 低于 大庆 胜利 华北 等 主力 油田 	M
苏州市 轻工业 系统 靠 营销 渡过 市场 难关 	M
来 逛逛 的 人 也 开始 稀少 了 	M
是 传统 中国 向 现代 中国 发展 过程 中 	T
目前 农会 有 的 由 盈 转亏 	T
常 因 心情 不佳 而 与 先生 口角 	T
私立 高雄 工学院 在 大树乡 创校 之初 	T
在 获利 微薄 的 情况 下 还要 打折 给 纸厂 	T
知识 生产 占 国民 生产总值 的 比重 越来越 大 	M
我们 看到 建设 规划 图 中 的 紫山大街 １９ 号 东面 	M
他们 与 南岸 的 制 梁 工场 开展 了 红旗 竞赛 	M
平均 每 位 小朋友 有 四 颗 乳牙 蛀牙 	T
财政部 国有 财产局 昨天 原则 决定 在 此 次 国有 财产 法 修正 中 	T
修改 其 直升机 与 飞机 的 议案 	T
这 不 包含 电脑 薪资 和 其他 费用 	T
在 水果 发展 中 还要 防止 单一化 倾向 逐步 调整 好 水果 内部 结构 	M
她 认为 这 是 学生 作品 报名量 减少 的 原因 	T
出席 者 包括 专程 前往 的 香港 知名 企业家 兼 收藏家 徐展堂 	T
没 给 家里 添 过 一 件 像样 的 东西 	M
他们 跟 我 说 你 提 不 起 勇气 打电话 给 我 	T
艰苦 的 以 七 比 六 获胜 	T
如 宋 以前 的 陶器 多 是 陪葬 的 明器 	T
甚至 发生 难以 执行 的 情形 	T
他们 表示 如果 金 泳三 坚持 己见 	M
有的 明显 不 适应 市场经济 的 需要 	M
观 之 大多 是 重 言 之 所 致 	M
演 到 痛 说 革命家 史 和 刑场 斗争 两 场 戏 时 	M
从 过去 作为 福利 实物 无偿 分配 	M
大传系 系主任 林静伶 已 就 此 事 与 教育部 沟通 细节 	T
促进 全国 各族 人民 的 大团结 	M
不能 走 发达国家 为 实现 工业化 曾经 走 过 的 过度 消耗 能源 材料 的 路子 	M
巴库 居民 的 生活 开始 恢复 正常 	M
他们 又 一 次 派 人 前往 	M
藉 记者 们 在 媒体 报导 	T
把 老百姓 手里 的 钱 回收 到 银行 里 	M
特别 是 允许 建立 与 国际 市场 相 衔接 	M
仅 尚 能 维持 廿 天 供水 	T
企管 硕士 学位 早已 成为 管理 发展 最 热门 的 一 颗 明珠 	T
大众 传播 系 的 萧伊宁 指出 	T
在 楼 外 的 人们 看见 一 场 撕 人 心肺 的 悲剧 就要 发生 了 	M
省委 省政府 的 主要 领导 同志 敢于 冒 这个 风险 	M
建筑业 是 经济 由 不景气 到 复苏 的 一 个 重要 指标 	T
他们 生产 的 洗衣机 的 洗 净 度 脱水 性能 噪音 磨损 率 等 主要 指标 不但 优于 国家标准 	M
内 亏 总额 超过 １０亿 元 	M
也 有 人 建议 丘子章 和 王 主任 不要 去 	T
以前 就 知道 有 这样 的 组织 	T
北京市 新闻 出版局 和 共青团 北京 市委 联合 举办 的 北京 ９１ 特价 书市 这天 开市 	M
每天 要 用 气 吊 把 １５０ 公斤 重 的 砂 箱 推 上 ３００ 多次 	M
促使 它们 急 企业 所 急 	M
受到 各级 政府 和 广大 农民 的 欢迎 	M
加强 对 城市 环境 综合 整治 的 组织 领导 	M
走遍 了 十三 个 公社 的 山山水水 	M
在 平等互利 的 基础 上 加强 和 扩大 两 国 经济 贸易 科技 领域 的 交流 与 合作 	M
波恩 政府 已 对 统一 热 作 了 一定 程度 的 降温 	M
学校 里 有 ５ 座 教室 	M
为 明年 的 全 国 大赛 作 准备 	T
专家 建议 学校 订定 优良 家庭 作业 奖励 办法 	T
与 浮动 基础 之 土木 界面 一 空气 弹簧 阻尼器 及 １２ 支 致动器 瞄定 的 界面 配合 	T
希望 它 能 以 大局 为重 	M
所得 情报 和 资料 为 同一 联盟 拥有 	M
所以 美元 升值 会 抵消 当前 廉价 原油 带 给 日本 的 好处 	M
主动 去 做 节育 手术 的 	M
务必 设法 寻出 遗骸 的 下落 	T
目前 这 个 只 有 一 梯次 的 营队 已经 额满 	T
只要 能 卖 钱 的 都 要 	M
未来 学生 和 校方 的 行动 	T
与 决策 机关 的 透明度 不够 也 不无关系 	M
如果 你 因而 必须 另 掏腰包 更新 硬体 设备 	T
他 在 画面 上 画 虾 蟹 青蛙 蝌蚪 扫帚 犁田 的 牛 小鸡 稻穗 菜蔬 果子 牛 粪 	T
威 有 一 本 魔法 书 	T
也许 博物馆 的 教育 做 得 还 不 够 	T
对 未来 之 发展 必 有 贡献 	T
但是 姬莲 阿姆斯壮 还 是 把 这 部 古典式 的 作品 	T
鞋 的 质量 问题 是 当前 消费者 反映 最 强烈 的 问题 	M
并 纳入 到 社会 经济 发展 计划 和 城市 建设 的 总体 规划 之中 	M
推荐 甄试 和 现行 联考 制度 搭配 	T
深深 被 这里 经济 繁荣 社会 安定 的 景象 所 激动 	M
如果 把 一个 封闭 型 的 企业 比喻 为 鸡 	M
将 尿液 送 县 卫生局 检验 	T
公布 成绩 排名 这 个 构想 是 来自于 国外 	T
还 将 讨论 上 次 未 完成 的 有关 推展 全民 体育 的 提案 	T
对 确实 贪污 犯罪 的 一定 要 坚决 依法 查处 	M
他 连 哪 方面 的 情报 值钱 都 不 知道 	M
经济 发展 速度 高 得 像 做梦 的 中国 奇迹 有 个 比较 确实 的 了解 	T
全国 第一 家 专利 市场 开业 了 	M
七月 五日 生医所 学术 咨询 委员 与 所 内 同仁 欢宴 时 也 以 此 共勉 	T
代表 消基会 与会 的 淡江 大学 交通 管理 系 副教授 陈敦基 则 指出 	T
前 几 天 因 有 人 偷 了 他 的 东西 	T
几 天 前 的 一个 上午 	M
倒是 几 个 偷 儿 泄 了 其 行藏 	M
广州 科技 人才 的 优势 并 不 突出 	M
该 蛇粉 标明 是 肝脏 解毒剂 	T
把 它 作为 一 项 基本 国策 	M
首先 映入眼帘 的 是 经营 大厅 内 悬挂 的 三星级 二星级 个体 经营者 的 彩色 照片 	M
祝愿 你们 在 亚运会 上 夺得 冠军 	M
原因 在于 荣总 毒物 中心 验尿 按 人头 收取 五百六十 元 检验 费用 	T
如果 价格 不 标 高 一点 	T
矿泉水 在 柜台 里 备受 冷落 	M
据 医疗团 副团长 刘台昌 自 沙国 与 他 联络 	T
我们 不能 使用 撒 大网 捞 大鱼 遍地开花 的 办法 	M
昔日 的 辉煌 灯火 和 繁华 夜景 不见 了 	M
而且 已 落 到 日本 和 德国 的 后边 	M
首钢 以 它 的 成功 的 实践 	M
其他 公司 则 可能 想 改进 各色各样 员工 彼此 之间 沟通 的 技巧 	T
是 公安 干 警力 擒 持 刀枪 动 歹徒 的 现场 一 幕 	M
捧 出 一 大 摞 资料 卷宗 呵呵 笑 着 	M
使 特区 的 建设 事业 继续 推向 前进 	M
砸 的 是 我们 管理 制度 不严 	M
工程 一 开始 就 没 停 过 工 	M
他 虽 没有 尝试 跳 过 	T
房管 部门 曾 多次 给 他 调整 住房 	M
煤块 哗哗 倒 在 传送带 上 	M
而 四 个 社团 在 东海 民主 广场 发表 的 联合 声明 	T
拥有 全国 人口 ８０％ 的 广大 农村 的 经济 面貌 已 今非昔比 	M
车间 工会 委员 两 年 一 届 的 选举 	M
他 认为 该 乡公所 有 护标 之 嫌 	T
举办 比赛 的 目的 主要 在 鼓励 大家 对 创作 产生 兴趣 	T
两 个 厂家 的 产品 一 方 典雅 	M
所以 来 参加 这 次 义工 培训 	T
王扶林 同时 透露 最近 中华 电视台 赴 北京 买下 红楼梦 之 分镜头 剧本 重新 再 拍 	T
它 也 不 希望 美元 长久 升值 下去 	M
因此 引擎 的 机件 必须 经过 特别 的 强化 处理 	T
土城乡 在 半 年 内 增加 了 五 	T
无 一 人 休息 过 星期天 和 节假日 	M
这 在 世界 上 都 是 没有 先例 的 	M
只用 了 ２３ 个 小时 便 调试 出 光 	M
我们 接著 看到 了 元文宗 的 天历 之 宝 御印 	T
但 其中 会 有 些 要求 	T
不 认为 做 机械 的 就 是 黑手 	T
李 放 操作 的 ８８８ 造型 机 十分 笨重 	M
这些 因素 都 是 造成 家门口 兵 难 管 的 环境 和 条件 	M
稳当 且 顺利 地 贮存 为 实力 	T
验 过 了 最后 一 台 中方 回 境 的 汽车 	M
一 年 平均 ５０万 以上 的 游客 光临 克鲁格 国家 公园 	T
在 治理 整顿 中 不 是 进一步 完善 发展 改革 措施 	M
十六 个 北约 国家 和 七 个 华沙 公约 国家 在 维也纳 确立 欧洲 传统 武力 谈判 的 范围 	T
周 彤 拿 着 鲜花 站 当中 	M
日本人 强制 台湾人 不能 唱 台湾 歌谣 	T
这些 人 可否 为 缔结 团体 协约 而 罢工 呢 	T
可 知 公务人员 与 公务员 是 有 区分 的 	T
并 亲自 把 饺子 达到 工人 手中 	M
提出 了 进行 政治 改革 的 一些 措施 	M
当然 不会 有人 买 这种 报 了 	M
皆 准备 著 完备 的 地图 	T
以 证明 白己 的 强大 经营 实力 	M
向 另 三 队 领队 提出 合理 的 答复 	T
不 是 随便 就 能 进入 	T
至于 你 认为 这样 的 发展 是 威胁 	T
温室 效应 就 会 越 显著 	T
又 不能 阻挡 商业 大潮 的 冲击 	T
只见 毛 如柏 同志 脚 登 胶鞋 	M
省人大 副 主任 梁 淑芬 副 省长 张 怀念 及 少先队员 们 欢迎 他 时 送给 他 的 	M
但是 他 不 懂 为什么 新竹市 会 受到 这 种 待遇 	T
后者 成员 中 虽 不 乏 与 县长 范振宗 对冲 者 	T
书法 册页 则 有 黄庭坚 的 花气薰人帖 等 名迹 	T
海军 随即 依 规定 将 船 押回 	T
后来 的 皇帝 又 不 像 乾隆 这么 雅 好 文物 	T
即 会 触发 暴戾 之 气 	T
目前 这 类 私药 还 售 至 台南县 永康乡 中正北路 四０三号 的 大 世界 中医 诊所 	T
对 市场 需求 不大 的 产品 要 限 产 或 停产 	M
如果 苏联 人 同意 悄悄地 离开 东欧 国家 ） 	M
就是 资本主义 的 东西 多 了 	M
恐怕 当 属 题 中 之一 义 	M
一 至 九月 制造业 的 总产值 以 美金 计 较 去年 同 期 下降 百分之四点六 	T
且 在 本 公司 年资 达 二十 年 以上 	T
参与 国际 竞争 要 有 明确 的 目标 	M
甚至 会 有 专家 来 教 你 如何 更 有效 的 运用 上班 时间 	T
欧共体 将 保留 制定 内部 市场 政策 的 独立性 	M
技术线型 突破 头 肩 底 颈线 部位 均 在 ３５００ 点 与 ３７００ 点 价区 产生 ７００ 亿 左右 的 巨量 	T
现有 的 人才 不 敢 用 不会 用 	M
电视 里 传来 飞机 马达 的 轰鸣声 	M
一 是 大 冷冻室 冰箱 流行 	M
将 会 产生 新型 收款 送货 公司 	T
在 台中市 被 查获 的 安康 公司 的 蛇粉 	T
二 连 举行 了 一 次 军人 大会 	M
因此 同学 骑 机 单车 左转 进入 宿舍区 时 	T
一方面 是 因 未来 经济 前景 不明 	T
有 些 词 今天 看 来 已经 酸臭 了 	T
宪法 第八十五 条 即 有 明定 	T
去年 东北 三 省 为 启动 市场 举办 的 一些 展销会 	M
在 大陆 都 是 不 适合 注册 的 商标 	T
陈列室 里 还 有 不少 胡适 先生 的 生前 用品 	T
一个 是 新 建成 的 武汉 港 客运 码头 	M
但 那 一 种 植物 有 毒性 	T
坐 牛车 捉 泥鳅 控土窑 等 活动 	T
竹东 镇代会 公害 防治 小组 对 居民 的 强烈 反映 甚 表 重视 	T
可以 为 国家 多 做 贡献 	M
虽然 他 将 剧本 一 改 再 改 	T
每 秒 约 四 至 十 次 左右 	T
是 地理 风水 中 所谓 的 地灵人杰 	T
此 役 裕隆 许东庆 及 林正明 在 下 半 场 以 纯熟 的 默契 	T
卫生局 在 七 八 两 个 月 抽验 市售 冰品 	T
并 将 请 已 开业 的 学长 上山 义诊 	T
从 序言 到 各 章节 的 具体 条文 	M
猎户 兄弟 上山 猎 虎 为 猛虎 所伤 	T
强 忍 着 自己 刚 开刀 尚未 痊愈 的 伤口 疼痛 	M
忽视 了 区域性 的 地缘 政治 	T
把 买 彩电 冰箱 的 钱 花 在 住房 上 总 有 点儿 不 情愿 	M
成为 武汉 文化 产品 的 窗口 	M
于是 这 猫 匿 儿 有时 也 就 成 了 现代 阿Ｑ 的 又 一 口头禅 	M
他们 的 程度 都 至少 升 了 两 个 年级 	T
现在 每 天 余震 还 有 几十 次 	T
或 主从 架构 中 频宽 的 加速 	T
在 日本 国会 ６日 下午 举行 的 参议院 全体 大会 上 	M
深圳 特区 是 邓 小平 同志 亲自 开辟 的 最 早 的 改革 开放 的 试验地 之一 	M
如果 真的 照 以上 之 类推 可以 成立 	T
美军 对 伊拉克 部队 进行 的 电波 干扰 已经 进行 了 近 １９ 个 小时 	M
它 原本 为 清宫 所 藏 	T
从而 使 美国 的 金融 市场 更加 不 稳 	M
不必 再 有 意识 型态 的 争议 之类 的 偏颇 论调 	T
这些 报 绝对 不 想 从 发行 上来 赚钱 	M
就 从 洞 口 钻 了 进去 吃 起 果莱 中 的 豆子 来 了 	T
他们 既 要 对 上 负责 	M
我 培育 的 种子 ８３ ６ 	M
今年 台湾 当局 在 处理 两岸 经贸 关系 时 也 有 松动 一面 	M
前 项 所 称 各 机关 系 指 左列 之 机关 学校 及 机构 	T
朝日 新闻 等 日本 传媒 接连 发出 中国 渔民 当 刮目相看 的 赞誉 	M
如果 要 不 懂 装 懂 或 讨价还价 	T
牡羊座 天生 的 勇猛 果敢 是 超群 至上 的 	T
多 是 海岛 夏 训 留下 的 黝黑 肤色 	M
反 六轻 领导 力量 也 以 展开 下乡 宣传 的 演讲 募款 活动 	T
有的 同学 拟定 计划 某 日 去 某个 地方 	M
宣布 和平 解决 海湾 危机 已经 让 位于 战争 	M
希望 今后 结合 著 具体 的 词 	T
而 华约 集团 由于 去年 下半年 东欧 政局 剧变 	M
ＮＩＩ 计划 成立 资策会 松山 新馆 台中 科博馆 高雄 美术 体育 馆 等 四 个 大型 展示点 	T
就 在 这 种 多空 对峙 的 情况 下 	T
摆 满 了 老年人 用 的 被褥 衣服 	M
随著 两岸 交流 的 正常化 法制化 	T
也 有 一些 同学 睡 在 广场 上 	M
严重 影响 员警 取缔 安非他命 的 意愿 	T
一 位 老人 率先 拎 着 一 把 壶 走向 第１１ 节 车厢 	M
美国 在 巴拿马 的 军事 行动 在 拉美 并 不 是 没有 争议 的 	M
并 在 不同 层次 上 开展 了 单项 或 局部 的 应用 	M
想 顺便 选购 合适 的 书 杂志 电脑 设备 软体 吗 	T
可能 会 引起 员工 的 不满 	T
筹划 着 在 上海 乃至 全 中国 谋取 进一步 发展 的 新 招 	M
把 各项 工 工作 推 上 新 台阶 	M
是 我国 发扬 社会主义 民主 的 重要 渠道 	M
当然 这 只 是 基本 的 原理 	T
使 此间 分析家 感到 有些 意外 	M
骨干 企业 大多 建于 一五 时期 	M
有的 人 还 振振有词 地 发表 一 种 谬论 	M
阿沛·阿旺晋美 副 委员长 来到 西藏 自治区 档案馆 	M
他们 大多 以 毕业 作品 参展 	T
却 引起 师生 极 大 的 反弹 	T
凡 今后 新人 欲 加入 职棒队 	T
难道 堪称 是 负责任 的 领导 者 	T
才 可能 从 根本 上 理顺 国家 企业 和 个人 在 住房 问题 上 的 关系 	M
院方 决定 进一步 传唤 香港 方面 相关 证人 	T
１ 当 你 觉得 泌尿 困难 的 时候 	T
味全股 这 次 因 市场 主力 介入 而 比 大盘 先行 回稳 	T
对 日本 实行 报复 性 制裁 	M
甚至 不 知道 运动 不当 会 造成 伤害 	T
全省 大型 重型 精密 机床 百分之七十 实现 了 数显 化 	M
长安街 以西 复兴门 外 大街 木樨地 路口 	M
与 吉他社 的 民歌 走向 差异 更 大 	T
为 人民 服务 是 无限 的 	M
离 破 堤 命令 要求 的 时间 只 剩下 分钟 	M
六十 年 前 三 镇 尽 成 泽国 看 今日 武汉 百 里 长 堤 巍然 锁 大江 	M
这 还是 受到 西安 城里 小 公共 汽车 招手 停 的 启发 理 	M
每次 他 都 以 最 多 的 票数 当选 	M
高阶层 主管 在 收到 陈情书 后 	T
学生 或 教职员 意见 若 以 书面 表达 	T
加强 党 的 建设 思想 政治 工作 和 意识形态 工作 	M
而 有 看 人 下 油料 	T
将 民国 七十四年 以前 占用 国有 土地 者 给予 合法化 的 承租 关系 	T
以及 黄益亮 每 周 固定 一 次 前往 左训 驻诊 	T
党 相 政府 十分 重视 环境 保护 工作 	M
各 民族 交流 激荡 的 痕迹 历历可见 	T
由于 没有 复杂 的 弯 道 	T
侵犯 别国 的 领土 和 主权 	M
大力 推行 污染 的 集中 控制 和 区域性 的 综合 防治 	M
被 水货 困扰 的 国内 进口 商品 业者 	T
索性 我们 乘 上 后 就 环城 绕 上两 团 兜兜 风 	M
大众 与 ＨＰ 的 合作 将 使 个人电脑 跨入 另 一 个 等级 	T
这 种 自欺 的 结构 非常 复杂 	T
对 继续 改革 开放 的 中国 内地 将 起 着 越来越 重要 的 作用 	M
中市 警二分局 系 于 一 星期 前 	T
希望 能 与 排湾族 学生 合作 	T
主因 是 可 从中 知道 自己 有否 进步 	T
有关 单位 就 拼命 往 后退 	M
好不容易 收集 完全 的 六十 本 台湾 各 地 古迹 调查 	T
只要 由 病人 将 细 导管 吞 入 食管 特定 位置 	M
５０ 多 家 出版社 和 书店 的 摊位 靠 墙 排 开 	M
已经 习惯 长久以来 兼顾 学业 与 篮球 的 生活 	T
商贸 国际 清楚 定位 在 海外 市场 	T
并 于 四月 中旬 举行 开幕 酒会 	T
还 在 那里 一 蹲 一 起 	M
三 是 广州 既 是 广东 综合 改革 试验区 省会 城市 	M
市府 用 行政 命令 的 办法 	M
许多 老人 解开 了 心头 的 结 	M
手里 带 着 一 本 我 在 美国 写 的 刚 出版 的 工程 控制论 	M
公共 网路 上 购物 并 不能 取代 传统 通路 	T
龙泉 作为 全国 一百 个 农村 电气化 试点县 之一 通过 了 国家 验收 	M
住宿 前 更 应 先 问 清楚 热 水 的 供应 时间 	T
酿成 这种 局面 自然 有 南方 国家 的 内部 因素 	M
饺子 也 都 吃 上 了 	M
但是 其他 公司 却 中途 退出 	T
要 担负 起 全面 领导 责任 	M
对 公司 的 工作 效率 和 声誉 也 会 有 严重 影响 	T
因为 书画 从 墓葬 出土 的 少之又少 	T
一个 身 着 灰色 西服 的 中年人 接过 话筒 	M
主要 是 因为 女方 害羞 不便 表达 	T
交易所 经理 部门 可 将 上市 公司 股票 迳行 暂停 交易 	T
但 智障生 无邪 的 笑容 却 令 人 心 悦 	T
酿成 了 波及 全国 的 长城 集资 怪 潮 	M
因 主机 故障 而 失踪 近 廿 小时 	T
但 晚上 吃 会议 伙食 和 看 电影 时 	M
用 低于 市价 ３０％ 的 价格 上街 廉价 叫卖 优质 袜子 	M
领导 着 拥有 十一亿 人口 的 国家 政权 	M
上海 荣华 楼 经理 李 余才 副 经理 李 耀震 多次 以 顾客 身份 前往 肯德基 家乡 鸡 快 餐厅 学习 	M
它们 的 领导人 也 已 获释 	M
广大 的 保护区 面积 相对 于 少量 的 游客 人数 	T
也 附庸风雅 溜 进 了 交通 路上 的 古籍 书店 	M
但 总 觉得 太 中国 了 	T
克鲁格 国家 公园 内 １６ 个 营区 可 供 食宿 	T
记者 在 大桥 上 看到 一 位 盲人 在 同行 人 的 陪同 下 	M
学校 能 为 同学 省钱 自然 尽量 做到 	T
他 操 着 一 口 流利 的 汉语 说 	M
单位 买 书 经费 实行 包干 	M
也许 短期 内 看 不 到 成果 	T
在 位于 友谊城 Ａ 座 四 五 楼 该 商场 ３０００ 多 平方米 的 营业厅 里 	M
一些 人 知道 了 会 骂 我们 的 	M
并 重新 检讨 自我 与 社会 的 关系 	T
香港 资本主义 制度 下 的 社会 经济 机构 也 将 继续 运行 	M
大家 的 修改 意见 多数 是 针对 文字 语法 及 部分 处罚 条款 的 	M
为 我国 拿下 一九九三年 亚洲 健力赛 的 第一 面 金牌 	T
相关 的 资料 被 大量 搜集 编印 	T
为 星球 大战 追加 ９亿 美元 经费 	M
少 竞争 蕴涵 了 一 种 深 层次 的 竞争 	M
或者 是 担心 他 输 在 什么 起跑点 上 	T
这 个 模仿 日本 及 香港 的 卖春 广告 方式 	T
而且 改善 了 过去 使用 者 常 找 不 到 档案 的 毛病 	T
或 撷取 自 神话 圣经 典故 	T
南港 经贸 园区 应 是 很 好 的 案例 	T
辽宁省 把 辽西 低产 果园 改造 列为 科技 扶贫 的 重点 工程 	M
你们 是 真的 替 我们 老百姓 着想 	M
一 袋 也 是 可 抵 西北 贫困 地区 农民 一家 全年 的 收入 	M
初步 形成 了 一个 集 装 卸 进 出 为 一体 的 化工 液体 集散 基地 	M
学校 逐步 形成 了 一 支 思想 活跃 	M
本报 刊登 关于 整治 广州市 八大 出口处 的 报道 	M
此 一 巨额 经费 令 警方 阮囊羞涩 	T
每 台 须 支付 新台币 三十三 元 	T
以 一般 常见 的 液状 染发剂 为 例 	T
攻方 球员 若 带 球 冲过 球门线 	T
比较 可以 在 聚会 中 用 各 族 的 母语 交谈 	T
相互 影响 的确 是 少年 吸安 的 主要 因素 之 一 	T
男子汉 生活 指南 教 儿童 读 古诗 等 生活 少儿 类 图书 也 销售 颇 快 	M
因为 全 世界 的 利率 纷纷 往 下 调低 的 影响 	T
以 江 泽民 同志 为 核心 的 党中央 深刻 总结 了 建国 以来 特别 是 两 年 前 那场 政治 风波 的 经验 教训 	M
两 人 自 民国 四十二年 官校 毕业 后 	T
欧洲 理事会 主席 爱尔兰 总理 豪伊 称 这 是 一 次 非常 成功 的 会议 	M
月球 于 三时 二十八分 退出 地球 半影 	T
其中 多 项 曾 获 全 国 金牌 	T
最 容易 为 人们 所 接受 的 观点 	T
而 铜陵 分别 是 ３４％ ２１．２％ 和 ９．２％ 	M
上 报摊 零售 的 报纸 几乎 全部 出现 了 滞销 	M
在 深圳 当兵 的 现役 军人 章 骏年 说 	M
中国 共产党 领导 的 多 党 合作 和 政治 协商 制度 是 我国 一 项 基本 政治 制度 	M
２ 商贸 国际 电信 网路 公司 由 七 个 年轻 朋友 集资 五百万 创业 	T
眼泪 簌簌 滚 下来 的 情景 	M
实施 过 这些 短期 训练 后 	T
吃饭 只好 饱 一 顿 饥 一 顿 凑合 	M
就 无法 完成 历史 赋予 特区 的 重任 	M
今日 的 创新 会 成为 明日 传统 的 一 部分 	T
加强 销售 无非 是 张 三 夺 李 四 的 饭碗 	M
就 有 一 个 是 吸安 个案 	T
已 于 上 周四 １／１４ 决标 	T
武钢 副 经理 赵 文源 和 李 运茂 赶来 了 	M
１１７ 号 班车 终于 顺利 到达 目的地 	M
滚石 唱片 让 你 在 家 就 可以 试听 	T
另外 ９９ 家 企业 在 对 当地 基础 设施 进行 评价 时 	M
那 能 料到 今天 在 陈列柜 公开 展示 	T
游客 可 在 香港 尝到 全 世界 最 可口 的 中菜 	T
还有 两 人 同 坐 一个 座位 的 	M
但 也 曾 出现 销售 困难 	M
子亿 从 里面 拿出 了 彩虹 滑梯 一 放 	T
其中 以 日本式 口味 的 最为 讨好 	T
阳阳 的 病 只有 做 骨髓 移植 手术 	M
在 金融 部门 的 支持 下 	M
这次 拍卖 将 会 使 贷款 到期 不 还 的 现象 减少 	M
北约 主张 应 以 北约 为 一 方 	M
与 邻近 的 繁 昌 县 作 比较 	M
两 个 红 螺蛳 附 在 玻璃 壁 上 来回 爬 动 	M
有的 在 企业 经营 管理 方面 有 经验 	M
厦门 地区 的 基础 设施 已 相当 完备 	M
必须 等到 另 一 学年度 才 能 领 	T
两 不 变 一 不 收 	M
可以 减少 传染 肝炎 和 肺结核 等 疾病 的 机会 	M
亚非拉 的 民族 解放 运动 和 反霸 斗争 大大 改变 了 世界 面目 	M
近年来 边境 贸易 使 黑河 与 阿穆尔州 建立 了 友谊 	M
其 将来 得到 肺气肿 的 机会 将 低微 	T
以至 两 个 孩子 的 小学 生活 	M
给 这 一带 留下 了 ２７１ 个 大大小小 的 沙堆 	M
武汉 对外开放 值得 骄傲 的 一个 优势 	M
参加 昨天 视察 的 有 市委 副 书记 市 纪检委 书记 刘 晋峰 市 人大 常委会 主任 吴 振 等 市 六大 机关 的 领导 及 有关 部门 负责 同志 	M
广州 在 这 方面 是 大 有 希望 的 	M
应该 也 包含 了 夫妻 间 彼此 的 恩爱 吧 	T
江劲彦 以 四 比 六 六 比 七 九 比 十一 受挫 于 卡斯维尔 	T
具体 方法 学生会 正 研拟 当中 	T
并 预计 今年 将 成长 ２５％ 至 ３０％ 	T
给 人 以 气势磅礴 神采飞扬 的 感觉 于是 进入 广州 的 人们 精神 为之一振 	M
计算机 这 东西 好 学 吗 	M
以及 清末 民初 这 两 段 时期 的 书画 作品 	T
这些 分歧 已 使 北约 内部 矛盾 趋于 表面化 	M
学生 有 住宿 方面 的 问题 可以 直接 找 学生 自治会 反映 	T
他 便 带 着 全乡 ４．２万 父老乡亲 的 渴念 	M
一直 通向 挂 着 ３０００ 多 盏 彩灯 夜 放 光芒 的 宝塔山 	M
做到 手 达 其 部 病 在 其 处 的 一 种 探寻 辨别 异常 病变 的 诊断 技术 和 一 套 独创 的 治疗 手法 	M
阿拉伯 各国 必须 采取 同一 立场 	M
水 电 气 管线 密 如 蛛网 	M
到 年底 转入 正常 生产 的 施工 进度 目标 	M
于 春 到 河畔 迎 新年 献艺 九 天 	T
江西省 今年 农业 投入 比 去年 增加 ２．６亿 元 	M
并 重申 了 杨 主席 对 国王 的 访华 邀请 	M
一 夜 之间 沙丘 就 能 搬家 	M
即使 三军 剧团 平时 公演 时 	T
宜兰 地区 反 六轻 力量 在 陈定南 	T
大多数 国家 均 把 高科技 产业 发展 和 传统 产业 振兴 升级 	T
也 有 老师 是 这么 做 的 	T
却 似乎 常 被 观众 遗忘 	T
究竟 适合 我们 自己 的 软体 何在 	T
因此 有 部分 文物 在 长陵 恩殿 展出 	T
把 上班 地点 从 井 下 搬 到 了 路上 	M
多 年 来 他 不 分 晴 雨 	T
而 军队 控制 下 的 黑人 居民区 更 无 自由 和 权利 可言 	M
同 世界 形势 的 变化 和 各种 力量 对比 的 消长 密切 相关 	M
聘请 李远哲 先生 为 八十三年 公务 人员 高等 暨 普通 考试 典试 委员长 	T
乡代 们 并 扬言 若 发现 仍 在 偷倒 垃圾 	T
但是 不管 是 二房东 或 三房东 	T
是 他 流放 黄州 时 的 作品 	T
新郎 必须 背 著 新娘 回家 	T
为 中 苏 两 国 在 各个 领域 的 合作 开辟 了 良好 的 前景 	M
把 擅 于 雄辩 而 清廉 的 海部 推 上 了 总裁 和 内阁 首相 的 宝座 	M
但是 民主德国 ３月 １８日 大选 后 的 形势 有 可能 导致 加速 德国 统一 进程 和 由此 而 出现 民 德 加入 共同体 的 问题 	M
有些 会 是 应当 而且 必须 开 的 	M
对 安盟 将 是 一个 沉重 打击 	M
但 因 事先 未 明文 通知 投标 者 须 同时 提出 缴纳 税金 证明 	T
大锅饭 千万 不能 再 香 起来 	M
在 刚刚 结束 的 工地 新春 对联 比赛 会上 	M
我们 每人 每月 必须 卖 出去 一 到 两 箱 袜子 	M
白 晰 的 脸上 还 戴 着 一 副 高度 数 的 近视 镜 	M
我们 母子 曾 共 有 过 这 一 段 十分 充实 愉快 的 学习 时光 	T
美国 继续 对 安盟 提供 外交 支持 和 军事 援助 	M
过去 的 每 轮 谈判 都 是 ２ 至 ３ 天 	M
这 种 局面 所 展现 的 正 是 讨好 中共 	T
有 一 座 地下 防空 掩体 就 被 炸弹 击中 	M
故 介入 此 种 多 被 配资 的 二 类 小型股 时 	T
每当 刮 起 ５ 级 以上 大风 	M
不知 谁 喊 了 一 声 	M
但 他们 凭着 对 人民 的 一 颗 赤子之心 	M
应 可 轻易 了解 其 利用 范围 及 价值 	T
同 处 一 江 景 不同 	M
美国 华尔街 股市 被 逼 得 走钢丝 	M
煤都 大同 井 下 工作面 的 采煤 工 们 眉飞色舞 地 互相 传递 着 这个 喜讯 	M
我 厂商 应 预 作 准备 	T
还 要 加上 适当 的 形象 塑造 	T
马 主委 自嘲 自己 为 颁奖 比 得 奖 还 多 的 选手 	T
比 法定 提交 日期 晚 了 ７ 天 	M
已 成为 仅次于 机械 纺织 工业 的 我国 第３ 大 工业 	M
再 针对 硬碟 的 使用 操作 管理 及 资料 备份 等 方面 做 介绍 	T
较 去年 同 期 增加 百分之九点一 	T
如果 按 现在 的 能耗 水平 和 未来 的 能源 生产量 估算 	M
幸 他 在 后 几 局 发球 和 击球 逐渐 稳健 	T
港务局 在 上午 接获 的 气象 资料 	T
对 美国 进行 为期 ４ 天 的 访问 	M
并 在 本 派 中 拢络 人心 	M
从 一 开始 就 有 不同 意见 	M
由 送审 至 出版 约 需 ８ 个 月 到 １ 年 时间 	T
单独 地 同 世界 各国 各 地区 及 有关 国际 组织 保持 和 发展 关系 	M
他 也 提醒 学员 应 注意 心态 	T
汇市 美元 昨天 以 廿七点廿五七五 开盘 后 	T
在 沈 太福 的 眼中 如同 是 几 张 废纸 	M
这 一 分歧 反映 双方 之间 尚 互 存 疑虑 与 戒心 	M
由于 这 类 私药 未 经 卫生 机关 核准 	T
全 国 各 单项 运动 协会 的 理事长 人选 	T
谁 会 傻乎乎 花 差不多 贵 一 倍 的 价钱 	M
为何 演唱会 取名 天 圣 地 贱 	T
达到 这 一 要求 的 仅 有 福建省 电子 工业 总公司 	M
台湾 是 一 多山 的 岛屿 地形 	T
扩大 了 阿拉伯 合作 委员会 的 影响 	M
再 用 少量 生理盐水 压 进 软管 	M
美国 已 难以 维持 其 在 西欧 的 军事 存在 	M
在 网路 快速 推广 之下 许多 站主 经验 不 够 	T
环绕 著 他 一生 的 各 种 论战 	T
在 会 前 他 请 三 组 院士 与 国内 学者 专家 分别 开 了 三 个 座谈会 	T
安 政府 方面 则 宣布 在 ４月 上 半 月 公布 政党 法 	M
多 是 天津市 副食 调料 公司 的 新品种 	M
剩下 的 票 都 到 哪里 去 了 	M
才 就读 小学 一年级 的 小 荳荳 	T
去年 的 总 兑现 款 是 １１１万 元 	M
敢 闯 敢于 敢 试验 的 结果 	M
便 开始 实施 基本 技能 训练 	T
共 有 十 位 男 学员 廿 位 女 学员 参加 	T
如今 家家 过 上 了 好日子 	M
这 同 全心全意 依靠 工人阶级 尊重 工人 的 主人翁 地位 并 不 矛盾 	M
至今 国内 向 无 此 项 土木 施工 经验 	T
不但 使 跨国 企业 积极 投入 	T
并 邀请 雕刻师 及 牧师 分别 讲解 卑南 雕刻 及 神话 传说 	T
国内 首 宗 抵押 贷款 房产 公开 拍卖 	M
受 邀 参加 研讨会 讲学 及 媒体 的 报导 	T
记者 罗际鸿 新竹 报导 新竹县 西滨 公路 竹北段 用地 	T
有人 劝 他 可以 上 井 了 	M
他们 才 会 先 用 垃圾袋 套上 石头 作 保护 	T
我们 决心 不 重犯 这样 的 错误 	M
中山 访 美 和 海湾 战后 日 外交 新 动向 	M
各家 科研 单位 再也 不能 干 重复 设计 重复 制造 闭门造车 的 傻事 了 	M
对 单方面 随意 延缓 或 无理 毁约 者 要 用 经济 的 行政 的 和 法律 的 手段 去 制止 	M
经 杭州 上海 北京 等 地 医院 对 １２９ 例 病人 的 临床 验证 	M
短期 内 日本 股市 不会 有 太 大 表现 	T
还有 围 在 一起 打 扑克 的 	M
新 的 电脑 辅助 功能 不只 让 产品 的 形象 提升 	T
义和里长 简清文 会同 十余 位 里民 	T
中国 金融 史 将 记下 这 一 不 寻常 的 时刻 	M
多 年 不 运动 的 中年人 	T
此 说 便 大 有 笼统 之 嫌 了 	M
大陆社 不 想 揪出 是 谁 破坏 	T
往往 被 电杆 挡 道 后 	T
美国 各界 对 新 预算 的 初步 反应 可以 归纳 为 	M
其他 跟 著 来 的 就此打住 	T
第二 是 纯 系 事业 之 经营 	T
音律 上 的 三 大 要素 为 	T
尤其 是 西德 和 日本 的 利率 上升 	M
于 昨天 在 埔心 农场 举行 义卖 慈善 园游会 	T
商场 便 拿出 了 ３００ 多 万 元 进行 内部 装修 	M
将 去处 的 转弯 路口 距离 所 需 时间 回答 得 一清二楚 	M
他 先 看 一 张 深圳 经济特区 总体 规划 图 	M
下 了 车 就 有 一些 换 钱 的 人 围过来 	T
再 以 相同 的 价格 出价 	T
北京 东四 北大街 路段 的 交通 变 得 混乱 了 	M
制裁 决议 是 在 伊拉克 拒绝 接受 和 遵守 联合国 要求 它 从 科威特 撤军 的 ６６０ 号 决议 的 情况 下 通过 的 	M
于 下午 三时 四十分 许 抵达 斗南 国中 	T
事实 上 仅 是 少数 不 受 景气 荣枯 影响 的 真正 有钱人 撑出来 的 架子 	T
各 剧团 的 剧本 多多少少 都 会 出现 类似 大陆戏 的 版本 	T
年纪 一 大 都 会 长出 一些 白 头发 	T
美国 更是 动不动 就 对 别国 使用 武力 或 以 武力 相 威胁 	M
充分 发挥 体委 和 教委 两 家 优势 	M
据 水林 营运所 主任 郑报 表示 	T
这 是 渔家 最 隆重 的 礼节 	M
在 实施 这 一 战略 中 	M
但是 当地人 仍 以 最 原始 的 工具 双脚 为主 	T
又 一 次 踏 在 处于 改革 开放 前沿 的 深圳 这块 热土 上 	M
他 计划 在 机场 申请 入境 签证 	T
从 宏观 的 角度 做好 以下 几 个 方面 的 工作 	M
本 省 周围 都 是 海洋 	T
在 我 曾 就读 工作 过 的 北美 大学 里 	T
国防 委员会 立委 周书府 怒 责 司法 委员会 主席 黄主文 不 是 国民党 的 一 员 	T
由于 黑面琵鹭 的 度冬区 就 在 七轻 和 钢铁城 的 预定地 附近 	T
他 希望 三 年 来 代表会 对 他 的 捧场 	T
深圳 要 更 好 地 发挥 窗口 和 基础 作用 	M
决定 １９９０ 年度 的 适用 对象 	M
他们 生产 的 红 江 橙 成为 国宴 佳 果 	M
去年底 又 大举 武装 入侵 巴拿马 	M
而 他 却 坚持 连续 施工 ５ 个 月 	M
李 总统 一 行 抵达 虎尾 镇公所 巡视 	T
副 厅局级 离休 干部 鹰潭 车站 离休 干部 党支部 书记 	M
这 一 宣布 使 北约 一些 成员国 哗然 	M
面包屑 菜 渣 米 饭粒 纷纷 落 在 睡 的 棉絮 旧 衣 上 	M
其 上 置 十三 盏 食物 和 纯 金牌 	T
看到 人们 引来 的 黄河 水 把 洼地 淤 高 了 	M
可 我们 却 长久 地 忽略 了 专利 这个 大 资源 	M
七 日 内 无 条件 全 额 退款 	T
比较 富有 的 男方 也 有 送 牛 的 	T
广东队 和 香港队 还 将 于 １月 １３日 在 广州 进行 本届 杯 赛 的 第二 场 比赛 才能 决出 胜负 	M
十分 适宜 于 开发 小 水电 工程 	M
豆娘 水虿 则 生活 在 溶氧量 高 的 溪流 石块 间 	T
由于 以色列 坚持 其 顽固 立场 	M
这 首 词 音律 最 成功 的 地方 	T
再度 展现 双手 反拍 的 强力 抽球 威力 	T
所以 实验 动物 饲育 的 各 种 严格 措施 若 不能 遵守 	T
除了 透过 交谈 练习 或 学习 母语 	T
将 此 作为 一 大 战略 正式 提 了 出来 	M
杭州市 公安 机关 经过 周密 侦查 	M
同时 维持 其 原来 的 目录 结构 	T
另外 有 ７４％ 的 企业 因 库存 积压 而 内 亏 	M
远远 赶 不 上 城市化 的 快速 发展 	M
因此 亦 就 自然 丧失 工会 所 特有 之 争议权 以及 行使 争议 行为 之 权利 	T
建筑 学者 德简 书院 主持人 王镇华 说 	T
给 大娘 端 屎 倒 尿 	M
牠们 却 要 面对 著 充满 不可 知 的 未来 	T
邓 楠 向 小平 同志 提起 他 在 １９８４年 １月 ６日 为 深圳 特区 题词 一 事 	M
但 战后 美 苏 关系 急剧 恶化 	M
随著 ＮＩＨ 推动 此 类 大型 计划 的 增加 	T
出产 呀片 食品 的 厂商 可口 食品 公司 表示 	T
该 会 调解 的 案件 以 车祸 为 最多 	T
这 不 是 个 好 办法 	M
前不久 建成 的 具有 世界 先进 水平 的 万 兆瓦 可 调谐 钕 玻璃 激光 装置 通过 了 中国 科学院 的 鉴定 	M
遭 村民 包围 工地 阻止 工程 进行 	T
他们 避免 了 常规 的 繁文缛节 	M
才 一 步 一 回头 地 离去 	M
海洋 公园 及 水 上 乐园 	T
引导 广大 人民 群众 自觉 走 科技兴农 之 路 	M
盖 棺 犹 未 论定 他 的 历史 地位 	T
林汉章 捐给 了 吴三连 台湾 史料 基金会 	T
而 关心 管理 者 身心健康 的 企业 也 愿意 负担 看诊 费用 	T
把 中国 人工 冶铁 的 年代 至少 向 前 推进 了 近 一 个 世纪 	T
并 力图 避免 该 地区 未来 发生 暴力 冲突 	T
便 暗中 和 一 位 好朋友 郭清泉 曾 任 台南 县议员 	T
也 是 最 引人注目 的 焦点 之 一 	T
停 痢 泻 科学 研究 取得 成果 	M
致使 不少 青少年 在 吸食 无罪 的 心态 下 	T
竞争 障碍 就 像 筑 了 一 道 的 厚 墙 	T
但 在 老师 的 立场 来 说 	T
波士顿 塞提克队 大鸟 柏德 右 三十日 在 对 华盛顿 子弹队 之 役 运球 上篮 	T
二 是 美国 主宰 的 北大西洋 公约 组织 的 苏联 控制 的 华沙 条约 组织 这 两 大 军事 集团 的 对峙 	M
将 档案 以 原来 的 形式 备份 至 磁片 中 	T
这时 我 到 美国 去 已经 ２０ 年 了 	M
铜陵 才 竖起 了 第一 批 永久性 广告牌 	M
但 未 获 学位 申请 认定 硕士 学位 者 	T
文艺 活动 安排 得 满满 的 	M
认为 这 是 不可逆转 的 	M
注册 了 集体 性质 的 长城 机电 技术 开发 公司 即 长城 公司 的 前身 	M
给 美国 经济 输 了 血 	M
近年来 武汉 开设 了 程控 电话 多少 万 门 	M
整个 石油 工业 才 有 后劲 	M
又 引发 了 多种 老年 疾病 	M
破格 提拔 了 一 批 中青年 教授 副教授 	M
在 家 投资 转帐 存放款 申请 信用卡 	T
帕金森氏病 不 是 罕见 的 病 	T
这么 做 的 好处 之 一 	T
这 是 此 型 人 最 具 特征 之 所在 	T
这 类 的 书籍 早 已经 蓬勃 发展 了 	T
当初 取名 呀片 系 意指 吃 了 容易 上瘾 	T
回顾 十 余 年 所 走 过 的 道路 	M
就 是 短期 性质 的 主管 课程 	T
在 请示 省市 有关 部门 之后 	M
应该 出席 的 ４００ 人 只 到 了 一半 	M
我 不 认为 自己 和 其他 人 有 任何 不同 的 地方 	T
原来 预计 的 电冰箱 购买 热 并 没有 形成 	M
她 过去 曾 接触 女性 主义 方面 的 课程 	T
海部 内阁 面临 的 这 三 大 课题 虽然 不 是 什么 新 问题 	M
再 论 为 实现 石油 工业 三 大 战略 而 奋斗 	M
能 快速 并 自动化 的 分辨 插秧期 及 最 高 分蘗期 影像 	T
美军 立即 启动 雷达 进行 干扰 	M
最终 目标 是 要 打动 目前 七千万 的 视窗 系统 使用 者 	T
当前 必须 强调 在 抓好 环境 质量 监测 的 同时 要 重点 开展 污染源 的 监督 监测 	M
我们 唱 咱们 工人 有 力量 	M
昨天 在 一九九０年 香港 乐高 十 公里 国际 路跑 双双 包办 了 冠亚军 	T
此 次 调查 弊端 能否 收 水落石出 的 临门一脚 之 效 	T
你 有没有 觉得 台北 的 冬天 愈来愈 没有 寒意 	T
他 每天 都 在 校园 里 查看 	M
为 了 学得 纺织 相关 知识 	T
宋代 迄 清 的 民窑 贸易瓷 铜佛 造像 等 	T
从未 停止 过 的 反腐倡廉 工作 也 取得 了 明显 成效 	M
本市 各行各业 都 要 结合 自己 的 工作 任务 	M
华视 当时 总经理 吴宝华 还 亲自 到场 迎接 	T
或是 跨 地区 跨 行业 参加 企业 集团 好 	M
分 从 最 低 的 五万 到 数十万 不等 	T
使 这次 访问 取得 了 重要 的 具体 成果 	M
除了 教学 目标 这 个 因素 	T
并 没有 什么 不 对 的 	T
我 希望 他们 是 自己 想要 做 	T
究竟 应 采取 核能 或 燃油 	T
其中 当地 企业 的 只 占 １／３ 	M
有 ２００ 多 家 企事业 单位 的 近 三万 名 团员 青年 走 上 街头 	M
但 凌厉 慓悍 却 是 他 的 致胜 本钱 	T
城市 是 经济 政治 和 人民 精神 生活 的 中心 	M
她们 在 吸安 后 便 会 开始 出入 不良 场所 	T
由 苗栗县 政府 及 有关 单位 研商 后 提供 多 点 改进 意见 	T
只要 是 人 结合 而 成 的 组织 	T
规定 凡 赴 大陆 投资者 都 要 登记 与 申请 	M
学生 投票 时 多 是 以 本身 所 感 出发 	T
只有 普遍 遵循 和平共处 五 项 原则 	M
在 一 片 保存 古迹 追寻 历史 的 呼声 中 	T
是 外商 投资 企业 的 支柱 	M
市 六 建 公司 第二 工程 处 发出 停止 施工 通知书 	M
挤 在 水龙头 前 洗衣 洗 菜 	M
所以 赛车 的 速度 相当 高 	T
并且 以 各 种 不同 的 作业 方式 达到 考核 学习 的 目的 	T
如果 是 那 样 的 规定 	T
那 是 多少 钱 也 买 不到 的 	M
以防 丧失 长 线 获利 的 机会 	T
浙江省 农业 银行 信用社 通过 调查 摸底 	M
新 预算 要求 向 东欧 国家 提供 ３亿 美元 的 援助 	M
所以 教学 题材 应 针对 学生 将来 在 社会 上 所 需 而 设 	T
并 应 按 省区 分别 规定 名额 	T
高 投入 为什么 没有 带来 高产 出 	M
绝大部分 单位 都 出色 地 完成 了 任务 	M
张 小姐 告诉 我 这 几 年 来 北京 的 新 建设 颇多 	T
不要 以为 这 又 是 上 精神病院 	T
就是 科技 兴 市 有望 之 时 	M
并 和 大陆 小朋友 做 才艺 的 交流 	T
不 刷牙 不 洗 脚 了 	M
是 因为 原舞者 明年 的 舞码 是 排湾族 的 舞蹈 	T
为了 抑制 一下 消费 过 热 和 市场 混乱 	M
比起 雄 鸟 真是 逊色 多多 	T
被 国际 艺界 视为 其 作品 能否 进军 世界级 展览 场所 的 关键 之 旅 	T
不 正 提供 了 决策 单位 正视 篮运 竞技 魅力 的 最佳 范例 	T
品牌 用色 灰底 红字 也 不容 忽略 变更 	T
不 像 我们 把 它们 通通 收 在 一 处 	T
月偏蚀 我国 境 内 能 见 	T
他 为了 照顾 老乡 的 面子 	M
职务 大大 落 在 同年 兵 的 后面 	M
但 总经理 邢 厚斋 断然 下令 返航 	M
工程 指挥部 派 人 去 通知 正 在 施工 现场 的 唐 启文 	M
会 不会 给 市 野生 动物 保护 协会 今后 的 工作 造成 被动 	M
上班 时 碰到 不可理喻 的 主管 	T
广州 市民 大 可 放心 重 九 登高 了 	M
它 便 能 发挥 神奇 的 威力 	T
国防部 却 便是 将 这 出 戏 压为 亚军 	T
台纸 昨日 暴出 仅 次 于 十月 二十六日 二万八千 张 的 大 量 	T
并且 将 在 十四日 于 国家 音乐厅 演奏厅 进行 成果 发表会 	T
大盘 开 低 震荡 再 杀低 	T
首度 总理级 会谈 曾 使 民众 大感兴趣 	T
然而 各 厅 局 部委 热情 倍增 	M
唐宁 一 行 三 人 昨日 下午 拜会 我国 教育部 体育司长 简曜辉 后 	T
地排车 载 着 吕 鸿宾 的 遗产 缓缓 驶出 院子 	M
方便 用户 能 迅速 进行 系统 升级 	T
咖啡厅 也 消费 过 几 次 	T
又 如 担心 大陆 没收 台资 等 	M
而 味全龙 将 也 因此 曾 匿迹 一 段 时间 	T
都 充分 证明 了 这 一点 	M
秦砖 汉瓦 唐 宋 名画 明 清 瓷器 	T
就是 抓住 一个 又 一个 机遇 的 历程 	M
只要 是 自己 喜欢 的 就 不 怕 卖 不 掉 	T
沈 太福 用 公司 的 钱 低价 购买 了 名 工程师 的 电机 发明 专利 	M
十几 年 前 她 曾 为 粮店 搭配 的 粗粮 而 犯愁 	M
具有 重大 的 科学 价值 和 社会效益 	M
千 余 双 眼睛 齐刷刷 地 集中 在 起来 观赛 的 省委 常委 副 省长 郭 裕怀 身上 	M
还 有 待 小组 成员 的 努力 	T
人们 比喻 为 大旱 中 的 两 场 及时雨 	M
用 奖金 鼓励 职工 购 收买 的 单位 	M
不会 有时 向 后 作 巨大 的 跳跃 	M
打开 一 扇 通往 世界 之 窗 	T
并 出席 中 义 变分学 及 相关 课题 研讨会 	T
要 如何 吸引 九年代 的 观众 	T
中国 渔民 实现 了 跨国 赶集 的 梦想 	M
解决 分配 不公 的 方法 只能 是 按劳分配 	M
最 特 特别 的 现象 是 要求 缩小 影印 的 学生 突然 变 多 了 	T
国内 正式 具 代理权 的 业者 想出 了 在 国内 再 申请 一 个 专利 标志 的 做法 	T
展开 推销 台湾 观光 旅游 的 宣传 	T
都 十分 珍视 中国 共产党 和 各 民主党派 的 亲密 合作 关系 	M
连续 两 个 多 月 埋 管 工程 	T
使 生产 企业 成 了 用户 的 代 储 仓库 	M
记者 在 人群 中 见到 长岭 机器 厂 驻 京 办事处 总经理 尹 香金 	M
却 在 消耗 人 的 精力 	M
还不是 把 全 班 的 成绩 登录表 给 学生 	T
但 日本 政府 和 篮球界 毫不 气馁 	T
对 中国 的 内部 事务 指手画脚 	M
赫拉维 总统 胡 斯 总理 和 侯 赛尼 议长 一同 出访 叙利亚 和 阿拉伯 三 方 委员会 成员国 沙特阿拉伯 摩洛哥 和 阿尔及利亚 	M
他们 中 的 １４亿 占 ８２％ 生活 在 发展中国家 	M
七十五 公斤 级 韩国 林治完 抓举 一百廿五 公斤 	T
国立 艺术 学院 美术系 一年级 马晓瑛 说 	T
根据 本 院 所 提出 的 网路 设备 规格书 	T
本 中心 即 积极 与 得标商 ＭＴＳ 公司 代理商 国科 公司 建筑师 结构 设计 单位 水电 工程 单位 及 土木 承包商 等 相关 单位 多方 协调 与 讨论 	T
由 农民 提供 土地 和 劳力 	M
教导 中山 学说 的 老师 对 本身 课程 的 认知 程度 比 其他 科系 老师 来得 高 	T
能 用 英语 给 我 指 路 吗 	M
日前 正 著手 研究 其 可行性 	T
国民党 中央 委员会 秘书长 宋楚瑜 在 中常会 后 约见 立委 党部 书记长 饶颖奇 时 表示 	T
菜 中 放 的 盐 减少 原来 的 一半 	T
不过 由于 这 个 媒介 色情 的 卡片 在 公共 场所 大量 散发 	T
连 不少 警方 人士 都 慨叹 错失 良机 	T
实际 参加 的 有 １１ 家 	M
也 决不 让 它 流入 市场 	M
可 称 之 为 实 乃 依法 统治 之 意 	T
因此 为 确定 什么 人 是 属于 那 种 身分 的 	T
你 是 一 个 精力 充沛 的 活动家 因 个性 使然 	T
这 是 一 个 既 复杂 	T
除了 一 张 床 一 个 衣橱 几 张 椅子 外 	T
看 了 一眼 老人 手里 真的 旧 锅 圈 	M
但 该 项 犯罪 所 占 之 百分比 为 百分之三十九 	T
希望 就 重大 问题 尽快 举行 美 日 首脑 会谈 	M
车子 不知不觉 到 了 皇岗 口岸 	M
二 不准 接受 战士 及其 亲属 的 礼品 	M
两 座 桥 的 引桥 桥梁 都 用 顶 推 方式 施工 	M
沈 太福 就 不能 以 假 技术 合同 的 非法 活动 来 骗人 了 	M
即使 剔除 一些 不可 比 因素 	M
此时此刻 却 握 着 护送 他们 来 的 领导 和 司机 的 手 	M
此时 渔港 如同 披 上 彩霞 满目 光辉 	M
其中 ９０％ 的 机构 是 用 集资款 开办 的 	M
我 给 大家 唱 支 歌 吧 	M
关帝庙 的 背后 就是 西堰村 小学 	M
交大 送 教育部 审核 中 的 中国 文哲 研究所 	T
番禺 县 国土 局 近日 对 黎 某 未经 批准 非法 占用 ７．６８８ 亩 土地 建 大型 住宅 作出 了 行政 处罚 决定 	M
总之 要 充分 发挥 主观 能动性 	M
这 是 因为 你 的 适应力 强 	T
美国 已 向 安理会 提交 了 一 份 决议 草案 	M
把 它 很 好 地 分解 落实 到 有关 部门 和 单位 	M
陈义信 若是 要 加入 国内 职棒队 	T
将 成为 亚太经济 圈 的 中心 	M
谈判 在 经济 货币 合作 欧共体 法律 制度 的 确认 四 大 自由 流通 及 配套 政策 等 方面 取得 了 积极 进展 	M
为 了 避开 外界 的 风言风语 	T
方 能 充份 发挥 电脑 效能 	T
始 可 接受 其 施工 品质 	T
在 涉及 到 其它 外交 问题 时 	M
其 目的 是 在 北京 露面 以 提高 知名度 	M
为 自己 创造 一 个 丰富 充实 的 旅行 	T
在 回答 调查 中 的 其他 问题 时 	M
一 是 回顾 了 友谊 华侨 贸易 部 成立 以来 所 走过 的 历程 	M
唐语谦 的 小 秘密 唐语谦 为什么 会 叫 唐语谦 呢 	T
报价 又 以 一 次 以 一万 元 交替 上升 	M
在 高 分辨率 超声波 扫描仪 的 引导 下 	M
他们 中 有 从 新疆 边境 归来 的 武警 战士 	M
工研院馆 则 推出 最 新 的 资讯 	T
据说 过去 张丰绪 曾 听到 有关 方面 考虑 派 空降部队 接替 他 的 中华 奥会 主席 职位 	T
大力 扶持 优秀 剧目 和 优秀 演员 	M
这 出 剧 是 描写 父亲 有 外遇 	T
去年 就 有 １０００ 多 名 教授 讲师 和 研究生 积极 参与 了 ５００ 多 项 课题 的 研究 	M
中华 功夫 国粹 馆 女 老板 黄淑梅 说 	T
我国 境 内 仅 能 见到 一 次 	T
这些 人 如今 都 是 统一 超商 协理级 以上 的 高级 干部 	T
但是 短期 内 台商 对 大陆 市场 的 看法 仍 属 观望 阶段 	T
就 连 土 生土 生 的 上海 小 绍兴 三 黄 鸡 也 受到 了 威胁 	M
无不 有 这样 那样 的 规矩 限制 得 死死的 	M
向 大众 公司 及 美国 科学 游戏 公司 询问 	T
连 住 得 最 远 的 裴 传温 也 天天 到 站 一 次 不 拉 	M
装机容量 １．２万 千瓦 的 瑞墙 电站 上马 了 	M
是 我国 第一 个 冷轧 薄板 生产 厂家 	M
往昔 的 强人 蒋 总统 们 	T
在 环境 及 健康 监测 的 工作 上 	T
荣成 渔民 跨国 赶集 中国 活 鱼 蹦 上 日本 早市 	M
此 地 一旦 被 填成 工业 用地 	T
该 公司 计划 以 无 业绩 压力 不 限制 竞争 产品 为 基础 	T
在 国人 注重 面子 与 尊 老 的 文化 传统 之下 	T
在 本 地 路线 取 近 海滨 地区 选 线 施工 	T
并 就 采取 的 协商 形式 作 了 说明 	M
并 不 希望 破坏 校园 景观 	T
守候 在 控制 中心 的 证券 交易所 研究 设计 联合 办公室 副总 干事 王 波明 兴奋 地 拨通 交易 双方 的 电话 	M
型 特有 的 理性 冷静 的 判断力 	T
我们 问 对 学习 有 影响 吗 	M
愈来愈 多 企业 现在 利用 心理 测验 	T
是否 经 市 规划 部门 批准 	M
又 使 金鱼 的 排泄物 便于 集中 	M
解决 好 一些 带 全局性 的 问题 	M
这 份 数万 言 的 报告 对 中国 的 政治 制度 经济 政策 社会 问题 都 一一 加以 指责 	M
就 能 进一步 巩固 和 扩大 爱国 统一战线 	M
武警 战士 和 县里 的 干部 帮助 喇嘛 们 从 废墟 中 掏 出 一些 佛经 佛像 和 其它 物资 	M
再 由 教授 来 选择 行政 人员 	T
但 单车 上 了 两 道 锁 应该 不至于 说 丢 就 丢 	M
含蓄 激动 的 热泪 久久 不 愿 离去 	M
林汉章 买 书 的 原则 是 	T
以 强烈 的 责任感 和 使命感 做好 环境 保护 工作 	M
他 笑称 是 自愿 来 打扫 的 	T
假如 你 能 抓到 ３ ４ 只 蟋蟀 	T
全市 各项 主要 经济 指标 全面 超额 完成 计划 	M
他 表示 安哥拉 政府 将 继续 努力 使 安哥拉 问题 得到 政治 解决 	M
在 室 内 吸食 禁药 安非他命 	T
一 位 曾 参与 和 伊拉克 会谈 的 苏联 外交官 十七日 晚 在 美国 电视 访问 中 说 	T
负责人 也 将 被 处 三千 至 三万 元 罚锾 	T
清华 大学 中国 语文 学系 四年级 刘嘉琪 则 指出 	T
放 一 把 火 烧 了 将来 满 屋子 的 藏书 将 何去何从 	T
而 专家 亦 建议 学校 可以 订定 一 套 优良 家庭 作业 奖励 办法 	T
却 被 足足 拖 了 四 年 	M
仅 知 与 他 聊天 的 该 名 光复 中学 学生 姓 廖 	T
全国 电子 行业 有关 厂家 有关 人士 褒贬不一 	M
并 同 贝克 国务卿 举行 会谈 	M
这 也 是 未来 教育 的 重点 吗 	T
最近 刚刚 取代 中曾根 派 会长 樱内 义 雄 而 打 起 渡边 派 旗号 的 渡边美智雄 还 想 利用 这 一 机会 	M
本来 是 李 放 的 不利 条件 	M
拖 着 疲惫 的 双 腿 	M
其实 就 是 他 前面 的 强人 未曾 收回 符咒 	T
并 议决 交付 系统 小组 调查 并 整合 各 所 需求 后 	T
有 一 种 盲目 的 优越感 	M
到 １９９０年 月 止 成长为 十三万五千九百五十四 人次 	T
中央 气象局 编印 的 今年 天文 日历 指出 	T
真 有些 带 着 枷锁 跳舞 的 味道 	M
拳击 等 三 项 必备 项目 外 	T
武汉 曾 有 一 条 相当 兴隆 的 文化街 	M
目前 北约 和 华约 的 具体 立场 仍 存在 着 不少 分歧 	M
我们 周遭 有 很多 的 玻璃 制品 	T
也 促使 他 揭示出 自然 神秘 的 运作 	T
大概 这 也 算得上 是 台湾 生命力 的 一 种 吧 	T
各个 部门 都 想 去 捞一把 	M
且 其 场 内 的 废水 也 经过 逆渗透法 的 处理 	T
伤口 拉 合 胶布 在 沈阳 问世 	M
沿途 还 有 讲师 讲解 古迹 的 由来 与 典故 	T
如 巨型 滑水梯 激流 旅程 七色 天梯 和 人造 浪涛湾 等 	T
或 身体 其他 部位 的 疼痛 时 	T
我 和 他 一起 分析 了 他 犯罪 的 原因 	M
他 是 怀 着 深深 的 痛苦 说 这 番 话 的 	M
国际 奥委会 主席 萨马兰奇 今天 在 墨尔本 称赞 说 	M
期待 每 一 个 先进 科技 的 全面 落实 与 推广 	T
国内 并 有 数十 家 厂商 参与 工作 成员 	T
三 是 一 套 夏 播 棉 标本 	M
我 需要 一 分 好 的 拼音 教材 	T
黑河 外运 公司 司机 吕 荣吉 早 ４时 就 赶来 排队 等候 运 货 	M
他们 从 中医 整体 观念 出发 	M
好多 地方 竟 把 它 蔓延 到 大街 上 	M
并 将 语言 的 表达 养成 习惯性 而 开口 交谈 	T
防止 和 避免 企业 的 超 负债 经营 	M
原来 李 放 向 车间 提出 了 增设 饮水 点 的 报告 和 实施 设想 	M
弹 到 路 旁 的 树 上 	T
将 使 海部 等 人 煞费苦心 	M
有 很多 是 反映 社会 现象 的 歌曲 	T
百 家 三资 企业 调查 表明 	M
这 也 是 上海市 演出 公司 的 宗旨 之一 	M
一 是 加强 和 改善 中国 共产党 的 领导 	M
并 拥有 丰富 的 精神 资源 	T
当然 有 它 制度 上 的 纷扰 与 历史 因素 累积 的 包袱 	T
京城 最高点 风 儿 送 问候 	M
从 常委 开会 的 气氛 就 可以 看 得 明白 	M
我 向 你们 拜 个 早年 	M
持 股 过 高 者 逢 反弹 宜 持续 减码 	T
但 当年 她 以 梁祝 一砲而红 	T
据说 各国 对 ６ 国 会议 应 定为 ２ ＋４ 会议 还是 ４ ＋２ 会议 曾 发生 争执 	M
送来 了 请假 信 和 请柬 	M
已 成为 国际 社会 普遍 关注 的 重大 问题 	M
而 在 寒暑假 作业 中 亦 明定 学校 必须 避免 抄写性 的 作业 	T
当 背 痛 伴有 以下 症状 发生 的 时候 	T
如果 战后 在 这个 地区 出现 一 轮 新 的 军备 竞赛 	M
日 美 间 必须 处理 的 这 类 问题 就 达 十几 项 	M
青海省 政府 已 拨 出 １００万 元 专款 帮助 灾民 渡 难关 	M
二 为 引进 项目 引进 外资 引进 先进 技术 对 有功 人员 的 奖励 费用 	M
医护 人员 从 药物 治疗 到 心理 关怀 	M
约 有 一千 多 人 被 炸 身亡 	M
依靠 自己 力量 配套 使 它 达到 ８０ 年代 世界 技术 水平 	M
在 参与 国际 竞争 中 发展 和 壮大 自己 	M
由 台湾 教授 协会 秘书长 陈仪深 演讲 由 本省人 的 历史 记忆 出发 	T
利率 却 比 ７０ 年代 中期 提高 了 一 倍 多 	M
在 经济 社会 发展 的 同时 	M
经过 一两 天 的 实践 后 	M
尽量 做到 经济 增长 和 环境 保护 的 协调 发展 	M
而是 他们 吹捧 的 那些 政治 精英 	M
他 便 甩 着 伞 上 的 水珠 急切 地 说 	M
就是 看到 上面 站 着 人 	M
是 经过 长期 实践 形成 的 	M
江 泽民 来到 乒乓球 馆 时 	M
我们 作为 广西 首批 大学生 营业员 	M
科技 领域 有 ２４００ 个 学科 	M
从 凌晨 ４ 点 钟 开始 就 赶 包 饺子 	M
向 为 国人 所 恃 傲 	M
但 多 位 成员 却 都 与 范振宗 私交 密切 	T
在 市委 的 正确 领导 下 	M
竟 骤然 间 静 了 下来 	M
尽管 德国 统一 的 步骤 方式 日期 和 前景 以及 德国 未来 的 地位 目前 还 处于 酝酿 阶段 	M
对 大案要案 不 严查 严 处 	M
南 抵 渤海 水深 ５ 米 以内 海域 	M
强调 联合 监测 既 能 真正 体现 增进 东西方 信任 这 一 宗旨 	M
你们 要 想到 自己 的 母亲 	M
故宫 佛教 文物 多 是 康雍干 三 代 的 供具 	T
日本 在 坚持 立即 全部 归还 北方 四 岛 和 经 政 不可 分离 的 原则 下 	M
拉近 一般 民众 与 科技 的 距离 	T
仍 被 政治 观察家 对 他 紧追不舍 	T
先后 组织 了 党员 革命 传统 教育 理想 教育 新 时期 十 年 优秀 影片 等 各类 专题 映出 ４０ 余 次 １．９万 余 场 	M
才 给 大家 带来 了 喝 水 的 方便 	M
大众 将 自 七月 初 起 	T
全 公司 只 售出 电动机 五六十 台 	M
三 家 公司 将 致力 发展 整合 各自 的 专精 领域 	T
软 土 深 掘 之 叹 	T
等价交换 中 蕴含 的 公平 则 是 一 种 内在 的 机制 	M
因 买 时 祇有 他 一 人 进入 	T
投资人 宜 密切 注意 价 量 关系 	T
立即 停火 实现 安哥拉 和平 已 成 了 安哥拉 全体 人民 的 迫切 要求 	M
有 老师 觉得 点名 很 累 	T
石油 工业 内部 面临 的 严峻 就业 形势 需要 多种 经营 开辟 就业 门路 	M
畸形 的 自我 也许 在 儿子 幼小 时 已 萌芽 .. 	M
横山乡 地方 民众 对 上述 现象 相当 不满 	T
与 邻近 产业 是否 发生 冲突 	T
和 一 只 倒 插 在 滑坡 下面 的 女人 的 腿 	T
从 汽车 里 将 桃 一个 不 留 地 卸下 送到 大厅 	M
相同 的 事件 如果 发生 在 台湾 	T
台北 国际 羽球 名人赛 昨天 上演 大 鼻 神童 阿迪 与 牛皮糖 傅国强 之 争 	T
所以 透过 学校 教育 来 提倡 艺术 	T
同时 部份 地段 之 河床 也 被 开辟成 宽敞 的 道路 	T
法国 总统 密特朗 发表 电视 讲话 	M
人 称 地下 博士 除了 对 读书 抓狂 地 热中 外 	T
即使 有的 项目 即将 成功 也 在所不惜 	M
不必 十 双 八 双 沾满 唾液 的 筷子 都 伸 到 同一个 碟子 里 去 夹 菜 	M
称赞 球场 旧 九 洞 的 风景 实在 宜人 	T
赞同 的 反对 的 责难 的 声音 都 有 	M
在 这 几万 种 商品 中 	M
但是 它 竟然 是 第九十三 次 综合 会议 了 	T
工资 与 奖金 的 增长率 应该 要 低 一点 	M
近 几 年 来 胡 女士 之 研究 广 受 注目 	T
我 觉得 是 根本 不用 插手 干涉 的 	T
辅仁 大学 行政 会议 最近 通过 学生 申诉 办法 	T
在 最近 召开 的 成果 鉴定会 上 	M
公司 正在 研究 如何 处理 善后 	T
居 农 八 师 １８ 个 农牧 团场 之 首 	M
环境 监测 以 其 重要 的 基础 地位 和 多方面 的 功能 越来越 受到 人们 的 重视 	M
除 转达 毛 部长 的 意见 外 	T
在 目前 的 国际 国内 条件 下 	M
虽然 剧情 对 唐语谦 而 言 	T
万 余 吨 周转 材料 全 靠 人 的 双手 搬 到 指定 位置 	M
自觉 地 为 维护 广州 安定团结 的 局面 而 作出 贡献 	M
不 知道 那天 会 塌 下来 	M
倒 也 是 亡羊补牢 犹 未 晚 矣 	T
由于 生物 医学 及 研制 新 药 不能 以 人体 作 实验 	T
法 美 首脑 会晤 与 中东 战后 和平 	M
也 因 韵 的 关系 不能 随意 变 	T
未来 的 中华 男篮队 不一定 要 和 欧美 劲旅 争长论短 	T
深圳 经过 １０ 多年 的 改革 开放 	M
三 年 到期 可 得 本息 １４２ 元 	M
晨跑 代表 我们 的 新 活力 	T
色 儿 却 在 清澈 透亮 水体 中 悠哉游哉 	M
他 就 说 他 迟早 会 有 外遇 	T
脸上 黑 得 辨 不 出 年龄 	M
能 用 外语 给 我 指 路 吗 	M
空降 的 高层 管理 人才 就 像 横向 移植 大 树 一般 	T
如今 人们 都 在 欢度 佳节 	M
持 刀 歹徒 在 车流 人流 中 左 突 右 闪 	M
你 到 别处 去 拣 吧 	M
全 是 ２３日 下午 市 计划经济 工作 会议 开会 时 缺席 的 部门 领导 同志 	M
再 转赴 其它 国家 取得 更 高 学历 	T
都 不 为 众人 所 喜欢 	T
具有 较 强 的 抑制 痢疾 杆菌 的 效力 	M
一个 企业 产 成品 的 库存 积压 超过 一定 的 比重 	M
老孙 点 着 一 支 烟 	M
可见 实际 利用 外资 的 比例 不 高 	T
进行 喷 药 的 效果 较 佳 	T
故 需 考量 其 特有 的 几何 校正 处理 程序 	T
也 存在 宏观 管理 上 的 原因 	M
正是 这 １４ 个 厂 的 负责人 	M
几乎 让 人 以为 置身 罗浮宫 	T
群众 才 会 真心实意 把 国家 的 事 企业 的 事 	M
大胆 进行 超前 的 改革 探索 	M
这 画院 学生 是 以前 的 官名 	T
宜 慎 防 是否 已 有 气势 竭尽 的 迹象 	T
这笔 大 生意 无疑 会 招来 西方 各国 大 企业 的 激烈 竞争 	M
去 一 次 怕 一 次 	M
１９９０年 国库券 在 沪 首 次 上市 发行 记 	M
今年 平均 每 口 探井 探明 的 石油 地质 储量 要 比 去年 高 出 近 ３ 倍 	M
然后 用 叉子 刺 著 面包 去 沾 乳酪 	T
贫穷 象 蛇 一样 缠 着 这个 村庄 	M
走进 奇妙 的 工作 世界 之前 	T
而且 还要 进一步 加快 改革 开放 的 步伐 	M
既 保证 了 学生 出 满 勤 	M
有 哪些 珍宝 入 宫 来 	T
各色人等 大约 均 会 无奈 摇头 曰 	M
如果 先 将 钉 尖 锤 钝 	T
有时 只 是 花 几 分钟 找 点 资料 	T
听说 胡 平 买 了 双 一日 鞋 	M
在野党 势力 要 超过 自民党 并 不 容易 	M
又 勉励 他 以后 要 加倍 努力 	M
走 一 条 符合 自己 国情 的 发展 道路 	M
论 苦心 大 是 周 彤 	M
穆 树祥 想到 连长 的 榜样 	M
亦 使 土壤 有机质 大量 流失 氧化 	T
至于 为何 十月份 平均 每 桶 购 油 成本 三十一点五八 美元 	T
不妨 事 前 找 分 目的地 地图 	T
时至今日 的 两岸 经贸 关系 是 势不可挡 的 	M
商业 部长 买 鞋 上当 记 	M
趋势 科技 除 以 产品 本身 的 全方位 功能 在 市场 上 保持 领先 地位 外 	T
像 蔡一红 洪荣宏 等 都 是 他 的 学生 	T
长安 田头 出现 招手 停 农机 劳务 服务 在 秋播 中 发挥 作用 	M
经过 十 余 年 全党 全国 人民 的 艰苦奋斗 	M
但 如果 出现 量 大 不 涨 的 局面 	T
林 市长 于 昨日 下午 三时 	T
现场 共 查扣 卅七万零五百 元 赌资 	T
也 就 是 补足 以往 宫廷 因 偏见 没有 收藏 	T
去年 二月 间 选派 专门 委员 萧伯雄 赴 韩 	T
杨 学宗 的 眼眶 湿润 了 	M
激起 资深 民代 的 强烈 反弹 	T
加上 小贩 的 叫卖声 和 小孩 的 哭闹 声 	M
但 实际 成分 却 含有 咖啡因 	T
挥 汗 拼搏 ９ 个 月 	M
按计划 将 在 ４月 下旬 提出 草案 	M
日前 来 台 设立 分公司 的 美商 宝得信 	T
基隆市 是否 也 向 台北市 买 水 问题 	T
一 位 ５０ 多 岁 的 老人 告诉 我们 	M
而是 楚 候 乡 老年 协会 和 村 老年 协会 合办 的 亮 衣 赛 被 会 	M
临河 市 离休 干部 乃 一太 半 年前 创办 的 剪报 专栏 大家 看 	M
很少 人 在 进出 大厅 之 际 	T
为了 鼓励 科研 人员 多 作 贡献 	M
其 速度 大约 为 每 年 二十八 ＣＣ 左右 	T
是 供 皇帝 们 闲时 摩挲 赏玩 之 用 	T
参加 联营 的 农民 人均 年 种果 收入 超过 １０００ 元 	M
是 对 深圳 人民 最 大 的 鼓舞 和 鞭策 	M
而 成为 一般 道路 使用 的 车种 	T
在 年轻 的 陈 辉 副 中队长 的 陪同 下 	M
虽然 目前 警方 正 全力 扫荡 安非他命 	T
墨尔本 申请 的 有利 条件 还有 澳大利亚 稳定 的 政局 	M
她 都 会 在 义卖摊 上 选购 些 物品 	T
当 国内 市场 趋向 饱和 时 	M
大多数 员工 都 已经 安排好 自己 的 时间 	T
８ 当 疼痛 让 你 无法 忍受 的 时候 	T
若 问 绳子 和 白 线 哪个 对 交通 管理 更 有效 	M
台大 课务组 也 建议 管理 学院 能 放宽 该 项 规定 	T
他 失去 了 活 下去 的 勇气 	M
现行法 中 民国 五十九年 以前 占用 国有 土地 者 得以 建立 合法 承租 关系 	T
新增 客户 增幅 比 停用 客户 还 多 	T
石油 工业 又 是 一个 以 采掘 地下 资源 为 特点 的 产业 	M
水 公司 基隆 第一 区 管理处 经理 杨政雄 向 市长 简报 表示 	T
由于 韩国 教练 不服 裁判 判决 林易衡 获胜 	T
按照 安 国防部长 的 说法 政府军 在 军事 上 又 占有 优势 	M
神明 与 人民 少 一 份 担心 	T
原住民 学生 也 有 同样 活动 	T
不得 擅自 加价 或 变相 涨价 	M
了解到 宇宙 生命 起源 的 奥秘 	T
厂房 的 主人 们 早已 完成 了 全年 的 生产 任务 	M
经济 工作者 几乎 天天 都 要 面对 这种 抉择 	M
深圳 特区 具有 其它 特区 和 开放 区 难以 与其 作 比较 的 条件 	M
新兴 网路 创业 族 已经 不再 是 梦想 	T
以 方便 野菊 能 顺利 接档 	T
德国 统一 问题 是 这次 会议 的 中心 议题 	M
只有 郊外 熊熊 燃烧 的 油田 大火 映 红 半边 天际 	M
人们 成群结队 纷纷 涌 向 港滨的滨江 大道 	M
需要 有 一个 和平 与 稳定 的 国际 条件 	M
一 条 是 试验 的 效果 不好 	M
有效 地 提高 了 铁路 综合 运输 能力 	M
以 十 比 八 顺利 领先 	T
正是 靠 的 这种 对 祖国 和 人民 的 拳拳之心 	M
希望 得到 其他 盟国 的 支持 	M
国家 的 财政 赤字 内债 和 外债 数额 巨大 	M
负责 统筹 金像奖 竞赛 的 国防部 政五处 上校 张乃东 指出 	T
因为 没有 社会 共同 认定 的 制度 来 维持 	T
李 鹏 总理 满意 地 挥手 称道 	M
设籍 或 服务 于 台北市 各 事业 单位 劳工 朋友 及 工会 会员 	T
请 他 支持 连队 的 工作 	M
我们 在 一九八八年 开放 八 所 自主 学校 	T
到处 都 是 绿色 的 海洋 	M
稍 不 注意 喷 浆 头 就 会 碰上 高压 电线 	M
涌 潮 作 墨 写 钱塘 春秋 	M
而 台湾 山区 的 气温 并 没有 明显 上升 	T
这 是 我们 对外 合作 交流 的 另 一个 重要 目标 	M
甚至 连 社团 留言本 也 被 不明 人士 在 上 写 了 脏话 骂 此 活动 	T
所有 这些 不能 说 与 片面 理解 稳定 的 方针 没有 关系 	M
整个 手术 时间 为 ２ 小时 	M
当天 学校 也 办 很多 耶诞 活动 	T
产生 了 高兴 和 恐惧 交织 的 感情 	M
国务院 还 据此 于 １９８５年 发出 有关 通知 	M
日本 市场 对 生猛海鲜 备 加 青睐 	M
月偏蚀 将 于 十二月 二十一日 下午 六时 零分 开始 	T
医护 人员 对 输血 针具 处理 宜 格外 小心 	T
大 联合 要 不 分 党派 不 追究 过去 的 历史 	M
科大 拥有 一 支 数千 人 的 教职员工 队伍 	M
跟 爸爸 耳语 了 几 句 旋即 返回 训练场 	M
而 应当 在 北约 共同体 和 欧安会 范围 内 来 安排 	M
最 广泛 最 充分 地 保证 广大 人民 群众 行使 当家做主 的 权利 	M
在场 的 县 乡 干部 们 深深 被 这 场面 感染 着 	M
黛粉叶 及 麒麟花 等 枝叶 会 分泌 白色 乳汁 的 植物 	T
将 他 九一年 初版 的 人祸 一 书 先 送上 网 	T
大 化肥 生产 实现 了 计算机 控制 	M
本 文 即 就 硬碟 组织 架构 和 基本 观念 做 一 简要 说明 	T
已 改变 了 过去 全部 抽取 地下水 来 供应 电厂 用水 的 情形 	T
洪福张 则 已 一路 直 上 	T
只要 娶 个 家财万贯 的 千金 	T
子弹队 葛兰特 左 赶来 防阻 时 	T
一 位 上尉 表示 进攻 很 成功 	M
虽然 每 天 练球 很 辛苦 有时 也 很 枯燥 	T
在 这 座 中东 历史 名 城里 是 满目疮痍 	M
向 警方 称 系 被 邀请 外出 喝 酒 	T
依靠 科技 进步 就 显得 尤为 重要 	M
占用 全部 流动资金 的 比重 高 达 ４８．９％ 	M
本来 是 两 个 矛盾 的 观念 	T
据 我国 驻 美 代表 处 经济组 传回 财经 单位 的 消息 指出 	T
用 人 的 孩子 死 不 光 	T
近处 的 拖拉机 就 应声 而 到 	M
要 他们 的 焦 书记 走 出 墓 来 尝尝 味道 	M
截至 昨天 为止 的 多 国 部队 四 天 全天候 轰炸 行动 中 	T
少 了 这些 文章 就 卖 不 动 报纸 	M
他们 会 在 下 周 发起 全 校 彩绘 石头 运动 	T
已 前来 台 进行 吴炫三 邀展 细节 的 代表 人士 有 	T
关于 德国 统一 的 ２ ＋４ 会议 	M
几 把 银 壶 在 黑色 夜幕 中 闪闪 发光 	M
韩国 政府 对 豪华 休闲 式 观光 及 外汇 加强 调适 措施 	T
波斯湾 战火 猛烈 的 此时 此刻 	T
苏联 和 东欧 的 局势 去年 发生 了 深刻 而 复杂 的 变化 	M
也 会 影响 特区 的 投资 环境 	M
而且 也 是 从 站柜台 干 起 	M
这 一切 却 要 无情 地 毁于一旦 	M
但 各 金融 机构 可能 怕 担风险 而 不 愿 大举 放款 	T
让 注册组 有 较 充裕 的 时间 预备 作业 	T
那 是 一 片 抓 一 把 可以 挤出 油 的 丰腴 之 地 啊 	M
一 位 女 同志 看守 着 脚下 几百 本书 	M
首创 电脑 的 视窗 界面 观念 	T
老师 授权 ２ 老师 一定 在场 ３ 上课 时间 内 	T
一般 认为 是 投资人 心理面 因素 在 支撑 	T
不但 看到 了 她 美丽 如昔 的 容颜 	T
小雪 的 母亲 张 新民 拿 起 话筒 对 丈夫 说 	M
两岸 经贸 关系 必将 向 更 高层次 发展 	M
凡 渠道 不 正 违反 有关 法规 的 不 演 	M
加上 近年 来 高解析力 卫星 资料 一一 出炉 	T
尽管 元宵节 前 的 天津 副食品 市场 依然 保持 着 腊月 以来 的 兴旺 	M
新加坡 的 社会 秩序 算是 好 的 	M
为 美国 经济 恢复 提供 稳定 能源 	M
普利马可夫 是 在 莫斯科 接受 访问 	T
他 干脆 就 守 在 人来人往 的 大门口 	M
迎接 ４０ 年 大庆 的 自治区 党委 系统 人大 政府 系统 和 政协 参加 义务劳动 的 领导 干部 职工 两千 多 人 	M
焦 裕禄 墓 前 的 嘱托 	M
大 批 工读生 都 受不了 引诱 而 染上 毒瘾 	T
雾峰 乡代会 人员 拍摄到 乌溪 畔 临时 垃圾场 被 断路 后 	T
使 其 成为 图书 报刊 音像 制品 文化 商品 的 集中 经营 点 	M
并 对 黄氏 过去 在 澳马会 的 丰功伟业 	T
参拜 一 番 后 并 与 闻讯 赶到 的 信徒 闲话家常 	T
于是 高古 玉器 成 了 故宫 近年 收藏 的 重心 	T
亦 于 昨晨 协请 空军 派 机 前往 出事 海域 加强 搜索 	T
你 在 工作 中 难道 从来 没有 遇到 过 不 愉快 的 事情 	M
就 是 消除 这些 危险 因子 	T
其中 二十五 种 奥运 项目 将 在 此 举行 	T
但 适度 地 未雨绸缪 却 也 无可厚非 	T
是 一 位 学生 与 汽车 对撞 	T
不少 人 敢 怒 而 不 敢 言 	M
而 诸如 雷震案 之类 的 政治 事件 	T
当初 国民党 的 两 年 三 阶段 退职 方案 	T
特别 是 德国 统一 问题 已 给 共同体 建立 统一 市场 和 推动 一体化 进程 增添 一 层 阴影 	M
为 阿拉伯 世界 进入 高 一 层次 的 经济 合作 	M
独 苛求 李 总统 出席 阅兵 	T
空旷 无 人 的 校园 里 	M
姑娘 们 挤 成 疙瘩 看 照片 	M
包括 组织 众多 的 小企业 走 专业化 协作 的 道路 	M
义卖 的 物品 大多 是 智障生 平日 上课 的 作品 	T
据 省 微型 计算机 推广 应用 办公室 提供 的 情况 	M
经由 该 会 选送 作品 参加 日本 廿一世纪 协会 主办 的 亚洲 儿童 画家 绘画 比赛 	T
那 一 块 石头 打 在 头 上 	T
这 和 牠们 稚虫 的 生态环境 有 直接 的 关系 	T
学员 们 满怀深情 地 把 延安 女大 比作 母亲 和 太阳 	M
就是 承接 东西 贯通 南北 的 中国 腹地 的 交通 枢纽 	M
无论 在 卫生 美感 和 噪音 方面 	T
而是 施 之 以 救济 	M
水南 村长 陈籐本 为 乡民 饮水 问题 	T
基隆港 外港 锚地 出现 八十余 艘 香港 渔船 进港 避风 	T
与会 的 校友 们 以 她们 共同 拥有 这笔 精神 财富 而 自豪 	M
我 想 可以 让 同学 更 深入 的 去 看 事情 	T
台北 名称 重回 世界 体坛 之后 	T
就 像 毛虫 要 脱离 茧 才 能 成为 蝴蝶 	T
就 难免 涉入 办公室 政治 的 漩涡 里 	T
是 以 语思 或 竹冰 的 笔名 刊登 	T
牛奶 不论 小孩 喝 还是 大人 喝 均 能 保证 供应 	M
原本 效益 好 的 厂家 反 亏损 近 ２００万 元 	M
或 其 损害 是 在 科学 上 所 能 认可 的 范围 内 	T
约翰·霍利曼 伯纳德·肖 彼得·阿尔纳特 在 伊拉克 首都 中心 的 拉希德 大 饭店 报道 	M
长期 呆 在 封闭 的 四 堵 墙 里 	M
记 不幸 遇难 的 兰詹 部长 	M
本 中心 新建 工程 包括 六 层 之 研究 大楼 及 实验室 之 建造 	T
我 不 爱 和 你 讲话 	T
拆线 后 在 皮肤 上 残留 缝合 的 瘢痕 	M
小 摊贩 也 摸透 了 城里人 的 心思 	M
才 改 在 室 内 举行 	T
引来 大陆 从 毛泽东 以下 举国 批 胡 	T
基本 路线 要 管 一 百年 	M
如 机场 扩建 开辟 首都 机场 路 立交桥 等等 	T
勇气 也 来自 班子 的 团结 	M
长安县 农牧 局 农业 科长 靳 尚斌 告诉 记者 	M
明十三陵 是 我国 帝王 陵墓 中 保存 比较 完整 的 一 处 	T
这 两 只 手 都 要 硬 	M
对 各 学门 有 初步 了解 	T
文化 名人 韬奋 先生 也 于 抗战 初期 在 此 办 过 著名 的 生活 书店 	M
但 寺院 的 大小 经 堂 和 住房 全部 变成 了 废墟 	M
因此 参观 陈列室 也 可 一饱眼福 	T
所 产生 的 各 项 课题 及 其 负面 影响 	T
如果 是 长途跋涉 到 大陆 去 	T
两 次 访华 都 留下 了 美好 的 印象 	M
这 三 大 场地 的 停止 运作 	T
反对 黎巴嫩 问题 国际化 和 分 而 治 之 的 邦联 计划 	M
并 建议 他们 进行 深入 的 研究 和 实验 	M
警方 除 依法 将 全 案 送办 	T
警方 受理 这 起 车祸 命案 后 	T
但愿 ３００ 名 学生 能 早日 进入 教室 上课 	M
故 始终 保持 水质 的 良好 	M
有助 网路 管理 人员 提升 通讯 及 分散式 电脑 运算 效能 	T
该 图样 是 代理商 专门 为 国内 上市品 而 申请 	T
然而 光 有 内涵 还 不 够 	T
宝物 最后 于 民国 卅八年 安抵 台湾 	T
外边 交往 应酬 大多 花 点 等等 	M
而 人民 也 会 给以 相应 的 丰厚 的 报酬 	M
其中 有 一 种 说法 认为 	T
制纸厂 永丰余 公司 的 专员 罗琼如 说 	T
由于 政界 不少 知名 人士 共襄盛举 	T
那么 他 将 失去 公正 的 判别 力 	M
以及 生发出 腐朽 气味 的 棺材 板 	M
目前 自己 开设 了 一 间 幼稚园 	T
这 标志 着 猪 禽 蛋 菜 的 生产 已 进入 从 传统 生产方式 向 现代化 转化 的 新 阶段 	M
认识 到 广大 工人 同样 决定 着 企业 的 命运 	M
譬如 苏珊莎兰登 饰演 的 妈妈 除了 温良 贤淑 	T
由 巴 美 对话 发展 到 有 可能 进行 的 巴 以 对话 	M
同时 坚持 按 国际 惯例 打 篮球 	M
日本 文坛 耆宿 井上靖 病逝 于 东京 	T
我 刚才 给 他 指 矿长 讲 的话 	M
德克勒克 作出 的 某些 让步 完全 是 国际 压力 的 结果 	M
全 年 名额 仅 限 １００ 家 	T
了解 癌细胞 在 体 内 的 生长 情况 	T
特别 提出 要 封 死 口袋 私人 腰包 	M
仍 偷偷 倾倒 垃圾 在 乌溪 畔 临时 垃圾场 	T
长沙市 业余 体校 与 市 第三十 中学 实行 联合 办学 新 体制 	M
因为 幸福 星 和 快乐 星 隔 著 银河 	T
我们 便 可以 在 大 的 风浪 中 临危 不 乱 	M
为 企业 融通 资金 ２０００ 多 万 元 	M
将来 陆续 会 有 针对 小学 低 中 高年级 及 国中 所 设计 的 教材 	T
ＭＩＴ 的 研究 由 陶瓷 单晶体 制造 高温 超导体 	T
台大 医学院 将 在 明年 一月 一日 起 在 医学院 内 设置 言论 广场 资讯 广场 学生 意见 信箱 与 定点 的 刊物 置物架 	T
养 在 深闺 人 不 识 	M
可以 应用 在 电子 设备 上 	T
符合 两 国 人民 的 根本 利益 	M
可 对 全球 的 四分之一 地表 进行 连续 的 观测 	T
具体 由 市政府 目标 办公室 和 市 查办 处 执行 	M
谨 以 与会 后 的 四 项 杂感 略述 于 下 	T
卡达 外长 哈达 在 开幕典礼 上 说 	T
而且 到 一九九三年 才 正式 上 了 本 地 院线 	T
人们 已 不 满足 于 同一 种 模式 的 灰 蓝 绿 	M
２４ 架 美国 Ｂ-５２ 重型 远程 轰炸机 也 已 到达 沙特阿拉伯 	M
而且 不 是 最早 的 用法 	T
在 已经 到手 的 中央 隆起 带 几百 平方公里 内 也 还 大 有 潜力 	M
有 人 提出 了 这样 一 个 问题 	T
但 实际 上 各 补习班 目前 一 学期 收费 大约 只 有 两万五 至 三万二千 元 之间 	T
东部 地区 都 将 承担 全国 原油 产量 的 大头 	M
但是 内心 都 存在 种种 疑虑 和 担忧 	M
郭 生 明 再也 抑制 不住 内心 的 激动 	M
分别 战胜 了 香港 钻禧队 和 苏联 莫斯科 斯巴达队 	M
穿 着 半截 羊 皮袄 的 尼古拉·彼德罗夫 说 	M
番禺 县 鱼窝头镇 几 位 居民 	M
预算 在 反映 世界 政治 形势 正在 发生 明显 变化 的 同时 维持 了 强大 的 国防 	M
以 脾 为 后天 之 本 为 理论 依据 	M
便 显得 船 沉 难 掉头 	M
病人 会 有 痴呆 等 智力 方面 的 异常 	T
是 在 上 大学 时 弃 学 从 商 	M
或 至 全 国 书展 选购 	T
这 不能不 说是 旧 的 福利型 住房 制度 使 投资 恶性循环 而 带来 的 结果 	M
并 当场 让 人 登上 仓 顶用 电子 测 温 仪 进行 了 测试 	M
便 会 在 辉煌 中 看到 不足 看到 令人 震惊 之 处 	M
一 名 在 现场 执行 爆破 任务 的 武警 中士 说 	M
来自 太阳 的 日照 为 大气 及 地表 呼吸 后 	T
不 符合 自身 利益 的 少 就 推 	M
可以 买到 各 类 新鲜 的 供应品 罐装 食物 以及 珍品 	T
关中 原野 出现 了 农机 流动 劳务 市场 	M
黄昏 渐近 却 带 不 走 金壁辉煌 的 湖 边 美景 	T
华尔街 股市 本 就 不 稳 	M
几乎 都 是 由 神父 和 修女 授课 	T
追问 他 是否 也 考虑 转入 新党 	T
而 出现 各界 情绪性 的 反弹 	T
捐赠 加 收购 的 新增 文物 总共 有 三万五千多 件 	T
而 在 指数 暴跌 下 被 套牢 	T
法国 总统 密特朗 ２７日 在 接受 意大利 电视台 采访 时 重申 了 关于 建立 欧洲 联盟 的 设想 	M
俟 此 一 资料库 建立 后 	T
而且 尚 在 不断 变化 之中 	M
象 当年 许许多多 的 青年 一样 	M
课务 组 将 收集 各 学院 的 单行 法规 	T
如果 依靠 宫廷 迷信 力量 要 去 解 咒 	T
我 不 想 再 拖累 家长 老师 和 同学 们 了 	M
可是 如果 我们 一味 坚持 不 撤 	M
大溪 分局 及 法务部 调查局 桃园 调查站 等 单位 的 签名 陈情书 	T
金融司 保险科 改设为 保险司 的 必要 	T
限制 在 该 机关 人数 百分之六十 至 八十 之 间 	T
成为 当时 有名 的 国际 都市 	T
少女 吸安 的 个案 竟 占 了 犯罪 总数 的 一半 之 多 	T
目前 有 些 先进 国家 如 德国 美国 英国 日本 等 国家 是 准许 公务员 可以 组织 工会 	T
而 研究 目前 国小 国语科 家庭 作业 情况 的 颜英 施秀美 徐蕙君 等 老师 则 建议 	T
我国 双打 连玉辉 陈志荣 击败 洪照熙 江劲彦 	T
他 不仅 为 自己 雇佣 了 保镖 	M
群众 的 生活 方式 和 消费 观念 发生 了 深刻 的 变化 人们 更 珍惜 时间 	M
车架 上 铁锈 脱 了 一 层 又 一 层 	M
络绎不绝 地 来自 全国 各地 的 考察 者 	M
咱 田头 也 有 了 招手 停 	M
是 这家 仅 有 １３１ 名 职工 的 小企业 的 首创 	M
必须 先 将 此 事 办理 公告 	T
一定 要 马上 寻求 专业 医疗 	T
自 本 年 六月 一日 起 	T
这 就是 办公厅 召开 发急 会议 的 原因 	M
或许 有人 要 说 这儿 的 老百姓 思想 太 狭隘 	M
十八日 拜访 原舞者 明年 寒假 去 屏东县 来义乡 古楼村 露营 及 三月 请 学长 座谈 	T
母 蓄菇 背 小 蓄菇 吗 	T
让 安非他命 列入 麻醉 药品 管理 条例 中 	T
有 清代 外国 大使 送 的 钟表 	T
如今 不动声色 地 走 到 了 全国 经济 发展 的 前列 	M
而 欧共体 亦 始终 拒绝 给予 非 成员国 以 同等 的 决策 权利 	M
希望 藉 他们 丰富 的 演唱 经验 	T
日本 已 成为 世界 上 的 第二 经济 大国 	M
收 上来 的 是 一 箩筐 的 好 话 	M
这 一切 都 寓 示 着 一个 新 的 工业 港口 城市 正在 孕育 之中 	M
政治 联盟 的 核心 是 共同 的 外交 和 防务 政策 	M
最近 许多 小朋友 出现 头痛 发烧 全 身 无力 等 症状 	T
赵 志浩 的 回答 非常 动人 	M
才能 推进 反 腐败 斗争 长期 顺利 地 开展 	M
市政府 是 如何 看待 的 呢 	M
由 山水客 工作室 与 山海 杂志社 主办 的 卑南 跨年 猴祭 文化 研习营 	T
我们 在 几 个 楼层 走 了 一 通 	M
钙 钠 玻璃 的 原料 由 矽砂 二氧化矽 石英 的 细 颗粒 碳酸钠 石灰石 碳酸钾 混合 而 成 	T
在 长岭 机器 厂 咨询台 旁 	M
国防 联席会 昨日 充斥 准备 表决 的 资深 立委 	T
每 袋 约 １０ 公斤 左右 	M
日本 将 把 苏联 列入 政府 开发 援助 对象 国 	M
季线 以下 各 期 均线 不但 呈现 空头 排列 	T
彼此 命运 各 异 的 发展 	T
一列列 客车 怀 着 渴望 而 来 载 着 满足 而 去 	M
当今 全球性 的 经济 技术 竞争 和 能源 财富 争夺 中 	M
义卖 活动 是 在 影 视 歌星 的 表演 活动 中 进行 	T
价格 也 为 原来 的 两 倍 	T
而是 一 项 旨在 增进 东西方 信任 的 措施 	M
隔 了 这么 久 没有 人 再 拍 	T
估算 了 ４４ 种 单 基因 病 的 基因 频率 和 携带 者 频率 	M
我们 就 能够 提高 国民经济 的 效率 	M
招手 即 到 不 跑 远路 	M
石油 勘探 开发 所 需 大量 自筹 资金 需要 多种 经营 开辟 聚 财 渠道 	M
这 张 画 后来 历 明 入 清 	T
汗 淋淋 地 等待 着 最终 时刻 的 到来 	M
我省 小 棉纺 企业 去年 资金 利税 率 要 比 大中型 棉纺 企业 低 得 多 	M
开 了 外国 博物馆 来 故宫 借展 的 先例 	T
第十三 组 彩券 也 出现 品质 低劣 的 情况 	T
只 见 在 一 大 堆 横七八竖 的 小 字 中 	T
南非 当局 是 迫于 国内外 的 压力 和 困扰 采取 上述 和平 变革 措施 的 	M
在 神经 移植 手术 上 受到 病人 极 高 的 评价 	T
不必 再 安装 烦人 的 驱动 程式 	T
是 一 项 知识 密集 技术 密集 设备 密集 的 系统工程 	M
十五 岁 林姓 少女 及 刘益志 男 	T
国家 实验 动物 繁殖 及 研究 中心 生产 的 ＳＰＦ 实验 鼠 和 一般 老鼠 有 何 不同 	T
江 泽民 和 运动员 们 在 吃 大 苦 	M
全都 挤 进 了 队伍 的 前面 	M
建立 政治 联盟 问题 是 由 法国 总统 密特朗 和 西德 总理 科尔 共同 提出 的 	M
美国 和 多 国 部队 能否 保持 这样 的 战果 	M
今天 仍然 称 妻子 为 内人 	T
大多数 已 在 自 尝 苦果 	M
原来 是 小 舢板 小 轮渡 	M
而且 可能 是 导致 安哥拉 和谈 中断 战争 形势 恶化 的 直接 原因 	M
苏联 不会 在 北方 四 岛 问题 上 作出 全面 的 让步 	M
对于 加强 和 改善 共产党 的 领导 	M
换 来 三 头 毛驴 和 农具 	M
解 铃 终 须 系 铃 人 	M
北约 欧洲 盟军 最高 司令 高 尔文 最近 却 表示 强烈 反对 任何 单方面 撤军 	M
这些 物质 的 变种 正在 陆续 发现 中 	T
硬是 给 咱 临河 街头 添 了 一 景 	M
春节 访 亚运会 电视 发射塔 工地 	M
所 修 课程 与 国内 同 级 同 类 学校 相近 	T
吸食 安非他命 已 跃升为 少女 犯罪 个案数 之 首位 	T
深圳 的 发展 和 经验 证明 	M
惟 行政院 在 去年 正式 行文 否决 了 公营 银行 员工 及 国防 事业 员工 以及 公立 学校 技工 与 工友 等 可 适用 该 法 	T
几 位 矿工 交头接耳 地 说 	M
这些 学科 的 相互 交叉 又 形成 了 几万 个 学科 	M
浙江 中 医学院 研究 成功 一 种 高效 安全 稳定 的 停 痢 泻 特制 肠 溶 胶囊 剂 	M
取缔 安非他命 的 脚步 是 不 是 太 迟 了 	T
现在 除了 几 家 原来 实力 较 强 的 还 在 苦苦 支撑 外 	M
三 人 居然 在 大陆 相逢 	T
多 年 来 一直 有 举办 比赛 的 构想 	T
咱 这 母鸡 不会 下 这种 蛋 	M
世界 似乎 变得 愈来愈 像是 一 场 巨人 们 玩 的 游戏 	T
而且 认为 目前 形势 有利于 实现 它 的 主张 	M
在 这 １５ 元 钱 买 下 的 一 车 垃圾 里 	M
这 个 案子 就此 结束 不得 有 任何 异议 	T
就 如 棋盘 般 整 然 地 排列 	T
教育部 需要 什么 样 的 人才 	T
就 停火 问题 举行 第７ 轮 直接 谈判 	M
可是 目前 国内 具有 防护员 资格 者 大多 已 有 工作 	T
并 按 有关 规定 缴纳 一切 费用 方可 施工 	M
小小 动物园 要 和 大家 说 再见 了 	T
自民党 联合 公明党 和 民社党 两 个 在野党 	M
她 会 用 成绩 来 证明 一切 	T
香港 与 新加坡 的 主管 人力 仲介 公司 近年 来 便 大量 仲介 中国 印尼 马来西亚 与 菲律宾 等 地 的 管理 职位 	T
现阶段 国内 艺术 环境 最 重要 课题 	T
而 在 做 天体 观测 时 	T
使 多种 经营 工作 始终 沿着 总公司 设计 的 战略 轨道 健康 发展 	M
实际上 就是 一 种 黑市 交易 	M
那位 营业员 就是 装 着 没 听见 	M
横贯 两岸 的 涌 潮 以 每 平方 ５ 至 ６ 吨 的 力量 拍击 着 桥墩 	M
本 台 记者 刘 振敏 报道 	M
而 十倍速 产品 也 已 进入 研发 阶段 	T
而 巨人队 此 役 两 名 投手 松原靖 	T
它们 担心 德国 统一 后 可能 脱离 欧共体 	M
柏油 路面 时速 不得 逾 ５０ 公里 	T
他们 警告 我 不要 配 冷 的 饮料 	T
抵制 高价 演出 和 低劣 演出 	M
裹藏 的 是 急切 与 焦躁 	T
如 最近 由 谢迺彪 制作 的 我 爱 美人鱼 	T
就 当成 是 有 人 比 我们 更 需要 而 没有 钱 	T
由于 他 自 小 在 日本 生长 	T
严重 背离 了 商品经济 的 要求 	M
若是 因 行动 不便 或 生病 	T
在 爱 中 长大 的 孩子 不会 变坏 吗 	T
因为 彩券 印制 都 是 电脑 操控 	T
因为 自由 要求 自己 怎么 去 负责任 	T
都 与 临床 结果 相 符合 	M
明星 们 挨打 被 侵权 要 打官司 或 有 什么 苦衷 	M
政府 宜 充分 利用 这 项 民间 宝贵 资源 	T
钱薇娟 拥有 一 个 球迷会 替 她 筹办 活动 	T
可能 会 因 他们 翩翩 风度 而 促进 女性 顾客 购买 欲望 	T
德国 统一 将 有助于 共同体 更 快 的 经济 发展 	M
这 是 继 朱 故院长 家骅 先生 于 民国 三十九年 出任 典试 委员长 以来 	T
正视 现实 承认 落后 的 目的 在于 奋起直追 	M
而 怪罪 该 校 罔顾 权益 封锁 该 路 	T
师 在 中国 传统 社会 与 天 地 君 亲 并列 崇高 的 地位 	T
使 湖 中 提供 氧气 的 水生 植物 茂盛 起来 	M
都 是 国家 计划 比例 大 年 实现 利税 ５００万 元 以上 的 生产 基础 原材料 出口 创汇 支农 和 人民 生活 必需品 的 企业 	M
中国 的 教师 与 真理 结合 	T
沙乌地 出口 的 石油 越来越 多 	T
人家 半天 就 立 了 项 	M
把 空中 的 三 位 舞者 转画成 一 只 鸡 	T
巨人队 与 联队 交手 两 次 全 战 皆 捷 	T
推动 石油 天然气 工业 不断 开创 新 的 局面 	M
邀请 校 外 学有专精 的 人士 	T
这 就是 服务性 行业 占领 市场 取悦 于 消费者 的 钥匙 	M
德克勒克 宣布 的 这些 改革 措施 丝毫 没有 触动 种族 隔离 制度 的 基础 	M
在 上海 外滩 东风 饭店 一隅 	M
专家 咸认为 多头 旺盛 的 攻击 是 为 行情 持续 看好 的 首因 	T
并 不 是 达成 目标 的 手段 	T
从 教育部 的 角度 来 看 	T
某 班 某 次 会 晚点 吗 	M
就 会 长达 一 二十 天 	T
这 就是 毛 主席 接见 过 的 焦 裕禄 的 女儿 焦 守云 	M
但 如果 要 找 与 研究 主题 有关 的 相关 资料 就 很 不 方便 	T
在 昨天 下午 近 五时 许 	T
中国 绍兴 为 栽培 兰花 最 早 的 地方 	T
虽然 自从 有 了 睡醒 故事 后 	T
他们 从 春运 第一 天 开始 	M
主管 部门 又 该 承担 些 什么 责任 呢 	M
而 使 乡民 汲取 水源 灌溉 农田 困难 一 事 	T
该 公司 唯一 的 产品 是 一 个 网路 上 的 多媒体 浏览 软体 	T
而 贡寮 系统 更 由 每 日 供 送 八万 立方公尺 	T
河北省 冀东 油田 经过 万 名 职工 艰苦创业 	M
但 长期 的 抗战力 却 非常 贫弱 	T
绘画 本身 就 是 一 种 创作 	T
由 力捷 投资 普雷 五％ 以上 的 股份 	T
他 把 它 擦 得 锃亮 	M
确认 只有 社会主义 才能 救 中国 	M
中国 积极 参与 环境 与 发展 方面 的 国际 合作 	M
二 是 由于 美国 削减 军事 开支 	M
一 位 家住 大央街 姓 费 的 老 武汉 在 黑色 大理石 标志牌 前 	M
将 分别 在 市立 体育 公园 进行 比赛 	T
维护 国家 的 长治久安 是 中共 和 各 民主党派 的 神圣 责任 	M
套 句 唐德刚 先生 的 话 	T
网际网路 适时 提供 了 中小型 企业 一 个 公平 竞争 的 机会 	T
自民党 和 经济界 首脑 都 表示 了 灵活 的 态度 	M
上市 公司 获利 并 无 明显 的 成长 	T
追赶 服装 的 时髦 成为 潮流 	M
而 这 项 决议 也 是 获得 学生会 的 同意 才 执行 的 	T
因此 公务员 之 服从 应 是 相对 之 服从 	T
也 是 全国 党员 干部 学习 的 楷模 	M
然后 两 人 人数 可 随意 增加 比赛 	T
船 上 载有 大 批 大陆 酒 	T
近日 光宝 集团 的 源兴 科技 又 延揽 了 十五 位 高阶 人才 	T
业者 对 月饼 新 口味 的 开发 简直 到 了 不遗余力 的 地步 	T
他 在 基层 指挥员 的 岗位 上 研究 的 是 最高 统帅部 关心 的 大 课题 	M
又 极力 保荐 其 妻 兄 王 唤之 儿孙 作 国史 修 撰 	M
许绩胜 成绩 为 廿九 分 四十七 秒 	T
在 一个 懒汉 受益 的 社会 里 	M
是 促使 觉醒 的 中华民族 形成 群体 的 批判 的 自我 意识 的 先决 条件 	T
也 坚持 以 严格 的 戏剧 训练 	T
然而 从前 几 年 的 勘探 效果 来看 	M
每 周四 晚上 七点 到 十点 	T
才 办 成一 件 又 一 件 实事 	M
中山 学说 可 说 是 许多 科系 的 基础 	T
势须 缩减 他们 在 非 必要性 或 奢侈品 方面 的 开销 	T
在 我国 的 政治 生活 中 认真 贯彻 这 一 文件 	M
并 非 能 在 人力 市场 上 自由 流通 的 系统性 生产 要素 	T
她 说 着 将 酱菜 放 入 购物 袋 	M
农村 市场 疲软 的 症结 在于 供给 与 需求 的 相互 错位 	M
若是 无 结婚 之 名 而 有 结婚 之 实 	T
江 泽民 对 矿工 们 说 	M
位于 平镇 工业区 内 工业一路 四号 的 宝荣 纺织 公司 	T
特别 是 捷 队 上半场 在 距 苏联队 球门 ３０ 米 外 罚 任意球 破 网 以后 	M
资深 网路人 描述 未来 资讯 的 变貌 	T
十亿 元 大 骗局 的 破产 	M
广东队 的 郭 亿军 在 香港队 门前 的 混战 中 破门 得分 	M
这次 调查 不仅 对 进一步 深入 研究 遗传病 因 学 流行病 学 预防 医学 和 康复 医学 等 提供 了 大量 可信度 高 的 资料 	M
加拿大 驻 西德 的 一 架 非 武装 军用 飞机 在 匈牙利 政府 的 协助 下 	M
负责 混合 化学 制品 的 员工 	T
除 设有 供 电视 转播 的 微波 平台 外 	M
为 发展 经济 往来 和 扩大 经济 技术 合作 提供 了 有利 条件 	M
分配 在 浙江 一 座 大型 水电站 工作 	M
就 成 了 华东 铁路网 建设 中 的 一个 关键 枢纽 	M
后来 书店 逐渐 被 日益 扩大 的 集贸市场 掩 没 	M
但是 却 激起 东海 校 内 一波波 的 涟漪 	T
进一步 加快 交通 运输 通讯 供电 供水 等 重大 基础 设施 的 建设 	M
而 全世界 大多数 儿童 恰恰 生活 在 环境 危害 猖獗 的 地区 	M
由于 均 坐 在 轮椅 上 投球 和 争 球 	T
由 活人 来 抢夺 供祭 孤鬼 享食 后 的 残余 之 物 	T
遇到 不 懂 的 找 资料 再 看 	T
预计 号召 一五 部 机车 在 板桥 地区 进行 机车 游行 	T
这 符合 我党 一切 经过 试验 	M
经费 预算 高达 十六亿 澳币 近 三百亿 台币 的 雪梨 奥运 申办 单位 	T
承认 安盟 作为 一个 政党 在 停火 后 自由 开展 政治 活动 	M
而 实习会 也 是 受 教育部 的 规定 	T
后者 导源 于 文化 上 的 鄙弃 	T
持 的 基本 上 是 赏玩 的 态度 	T
顺着 他 的 面颊 滑 下落 在 了 他 的 双臂 上 	M
做 学问 全 凭 自己 摸索 	T
且 又 以 重化 及 技术 密集 工业 产值 占 全体 制造业 比例 的 百分之六四点一 	T
从 近海 的 平原 地形 到 有 高山 环绕 之 水库 山地 地形 	T
对 对方 是 一 种 侮辱 	T
至 ４０００ 点 心理 关卡 主力股 仅有 调节 的 筹码 	T
特区 不少 国有 企业 经济效益 不 佳 	M
这 或许 是 政治 经济 和 生态 保育 间 的 窘境 吧 	T
若要 在 国际 体坛 上 占有 一席之地 	T
我 领会 延安 精神 中 最 重要 的 一 条 是 坚定 正确 的 政治 方向 	M
无论 别人 笑 他 阿达 疯子 	T
用 腹部 紧贴 著 笼子 底 	T
商品经济 与 科学技术 两者 是 互为 依附 互相 促进 的 关系 	M
我们 对 油气 分布 规律 和 富集 规律 不 可能 一目了然 	M
且 十二月份 购 油 成本 降低 	T
人家 桃园 当选 五 位 中央 委员 	T
出席 全 美 癌症 学会 第八十五 届 年会 的 感想 与 见闻 	T
骑 脚踏车 前往 其 菜圃 种菜 	T
如 在 １０月 ６日 正式 实施 对 大陆 地区 从事 间接 投资 或 技术 合作 管理 办法 》 	M
一些 能 赚 大钱 的 像 家电 之类 的 营业 场地 	M
倒 也 与 老衲 有 几 分 善 缘 	T
他 还 表示 反对 让 一些 东欧 国家 加入 欧共体 	M
且 周均线 亦 能 奋勇 上 穿 周均线 形成 黄金 交叉 	T
再 比如 为了 让 自己 的 产品 占领 市场 	M
高年龄 男性 家族 病历 和 抽烟 可以 说 是 肺气肿 的 高危险 因子 	T
时间 安排 不妥 会 导致 低出席率 或 增加 付费 教室 的 使用 时间 	T
去年 曾 因 盛传 美国 要 降低 利率 出现 过 股市 行情 稳步 回升 	M
但 却 提供 比 电信局 更 好 的 服务 	T
这 本 白皮书 是 一 个 政策 文件 	T
而 找出 能 提供 教育 训练 协助 的 单位 	T
新竹 随选视讯 示范 计划 系统 采购 先前 已经 经过 两 次 投标 	T
该 局 打算 向 财政部 提案 要求 拨补 新台币 五十亿 元 	T
建立 这样 的 国际 政治 新 秩序 	M
国家 高速 电脑 中心 暨 中正 成功 中山 清华 交大 台大 中央 等 七 所 国立 大学 为 配合 国家 基础 建设 ＮＩＩ 计划 	T
过去 是 有 货 不 愁 销 	M
将 世界 和 工业界 的 动向 提供给 教育部 	T
也门 常驻 联合国 代表 阿什塔勒 ２８日 说 	M
我们 首先 来到 吴 明栋 家里 	M
德克勒克 提出 的 改革 和 谈判 措施 有助于 结束 南非 的 种族 对立 状态 	M
使 台银 一直 无法 将 比数 拉近 	T
高能 出类拔萃 的 业绩 得力 于 它 的 人才 资源 	M
当今 世界 事务 中 这 方面 最 突出 的 事例 	M
大学 已 制定 了 一个 复课 计划 	M
双 保 责任 给 各级 政府 和 经济 部门 增加 了 压力 	M
小 邢 阳 因 患 淋巴细胞 白血病 已 离开 学校 半 年 多 了 	M
还要 把 你们 的 妈妈 照顾 好 	M
希望 学生 不 只 是 专注于 学业 	T
世界 正 处在 政治 经济 大 变动 时期 	M
建立 于 １９６６年 的 科威特 大学 有 医学 文学 法律 商业 经济 理工 石油 工程 和 教育 等 十几 个 学院 	M
他们 不能 了解 佛洛姆 的 哲学 	T
一般 在 抢婚季 过 后 接著 就 举行 丰年祭 	T
对于 寻找 戴传贤 先生 遗骸 的 下落 	T
据 承办 单位 台南 青年会 表示 	T
使 科技 成果 变 三军 仪仗队 为 远征 十字军 	M
台北 市立 社教馆 明年 十月 中旬 休馆 一向 是 文艺季 演出 重心 地点 的 台北 市立 社教馆 	T
台机 为 推动 此 项 人事 精简 	T
切开 后 内 有 许多 坑洞 	T
唱 的 也 都 是 些 混血 歌曲 明明 是 日本 歌 	T
他们 可不 是 下放 一 年 的 临时工 	M
说 得 小平 同志 笑 了 起来 	M
利用 已经 形成 的 相当 规模 的 钢铁 煤炭 电力 石油 资源 	M
黄牌 车 的 出现 顿时 成 了 众人 议论 的 话题 	M
这 个 地方 是 本 院 同仁 之间 的 一 个 重要 交谊 场所 	T
整个 北京市 改革 的 势头 很 好 	M
其 主要 原因 就是 对 停火 协定 附件 中 关于 停火 和 大选 时间表 的 规定 不 明确 	M
有的 井队 的 针线 簸箩 库 半 年 不 领 料 	M
使 安哥拉 早日 实现 人们 盼望 已 久 的 和平 	M
可 要 说 把 它 砸 了 	M
否则 就 应 在 劳资 争议 处理 法 中 明定 排除 之 	T
老衲 见著 他 了 王 主任 说 	T
而 复建 方面 的 物理 治疗 	T
也 让 我 思考 一 个 问题 	T
下属 企业 的 经理 们 普遍 反映 	M
所以 在 正式 使用 前 必须 先 经过 测试 	T
工人 立法 行动 委员会 十二日 发动 １１１２ 大游行 	T
可 处理 ５ ＭＢ 内 之 资料 	T
私立 学校 与 公立 学校 不同 	T
每 个 学校 的 学风 却 是 延续 的 	T
而 目前 已 有 十四 所 场馆 完工 	T
英国 首相 撒切尔 夫人 曾 表示 反对 讨论 这个 问题 	M
至于 去年 全 年 平均 总指数 则 为 一百一十点六九 	T
现在 却 有 油 加 不 上 	M
况且 宽度 是 如此 的 狭窄 	M
佩戴 站长 臂章 的 黄 献山 告诉 记者 	M
表彰 他 为 祖国 科技 事业 的 发展 作出 的 卓越 贡献 	M
国内 产业 为 日商 垄断 伤神 之 际 	T
台大 生活 辅导组 主任 洪继志 答复 	T
然而 在 南港 胡适 纪念馆 的 手稿 	T
正 实施 第三 阶段 限 水 中 	T
有的 在 国家 政权 建设 和 精神文明 建设 中 能 发挥 积极 作用 	M
因此 选中 此 地 为 明 王朝 的 万 年 寿城 	T
相比 武汉 改革 开放 的 诸多 大事 	M
但 这 总 比 一点 都 没有 强 	M
４ 经营 电子 通路 不同于 传统 通路 	T
督察室 人员 系 于 日前 获报 	T
仿佛 什么 事 都 没 发生 过 	T
每 一 首 歌 都 代表 著 点播 者 的 祝福 	T
去 某地 有 那 次 车 那 班 船 由 汉 出发 	M
于 四月 三十日 于 该 校 隆重 举行 	T
江 泽民 同志 大步 走 来 	M
大多数 外商 对 出于 追求 事业 的 成功 而 选择 来华 工作 并 不 后悔 	M
另 一 栋 则 尚 在 规划 中 	T
这 个 意思 和 另 一 个 成语 大智若愚 差不多 	T
科学 计划 一向 争议性 较 少 	T
八 大 出入口处 道路 宽广 洁净 	M
以 扩大 目前 传统 速度 为 １０ Ｍｂｐｓ 的 频宽 	T
中华民族 的 价值 取向 要 靠 散布 全球 各 地 的 中国人 华人 以及 关切 中国 文化 	T
即 享有 所谓 的 例外 权 	M
既然 伊拉克 已经 完全 撤出 科威特 并 接受 了 安理会 的 所有 １２ 项 决议 	M
许多 老师 由于 不 想 自身 既得利益 受损 	T
迟 至 昨日 下午 一时 卅分 	T
如此一来 就 能 在 美国 为首 的 盟军 发动 代价 巨大 的 地面 攻击 之前 结束 这 场 战争 	T
千 余 名 口 干 唇 燥 的 旅客 把 渴望 的 目光 投向 站台 	M
以及 １５ 种 多 基因 病 的 遗传 度 	M
这 是 中国 共产党 同 各 民主党派 合作 的 政治 基础 	M
两 国 政府 关于 在 中国 合作 建设 核电站 和 苏联 向 中国 提供 政府 贷款 的 备忘录 等 多 项 文件 	M
都 是 喜爱 拈花惹草 的 爱花人 必须 具备 的 常识 	T
据 主办 单位 中元 祭典 委员会 主任 委员 林正泰 指出 	T
据 广州市 城市 建设 开发 总公司 江南 地区 公司 有关 同志 介绍 	M
也 就 必然 选择 中国 共产党 的 领导 	M
也 是 令 人 喜爱 的 	T
积极 选购 经济 文化 思想 法制 科技 教育 等 方面 急需 的 短片 	M
我 总结 了 一 套 简化 易 记 的 词谱 	T
仍 有 不少 群众 被 围困 水中 	M
党 和 人民政府 十分 重视 麻风病 的 防治 工作 	M
但是 只要 有 人性 的 介入 	T
提供 咨询 给 想 在 台湾 做生意 的 外国 厂商 	T
如此 又 应 了 中国 的 一 句 俗话 	M
还有 钢筋 头 螺钉 螺母 旧 车刀 	M
幸 其 父 请 炀帝 降旨 停止 比武 	T
厂商 在 建立 正确 观念 之前 	T
但是 多 一 种 新 的 素材 	T
以色列 此举 不仅 威胁 巴勒斯坦 的 和平 倡议 	M
政府 成立 了 国家 长期 发展 科学 委员会 	T
就是 上届 省委 提出 来 的 	M
由 女性 权益 促进会 主办 的 新 美丽 佳人 女性 生涯 规划 营 于 日前 结束 	T
有 两 脚 书橱 之 称 	T
非 要 数十 名 早早 赶来 的 旅客 多 等 一 小时 	M
这 是 １９９０年 在 国际 关系史 上 留下 的 重要 记载 	M
儿童 也 难以 幸免 空气 污染 和 有毒 化学品 的 危害 	M
五 名 正副 厂长 书记 挤 在 一 间 不到 ２０ 平方米 的 办公室 里 	M
好处 则 是 省下 了 长期 合约 的 成本 	T
最后 一 站 到 花莲 结束 	T
非 同步 传输 模式 是 全球 公认 唯一 可以 解决 现今 所有 网路 架构 问题 的 技术 	T
一 前 一 后 几 步 路 	M
借重 他 在 国际 大 公司 的 经验 	T
寻找 效益 最 高 的 就业 位置 	T
人 的 生命 是 有限 的 	M
沈 太福 先后 指使 有关 人员 开 出 ２亿 元 的 假 发票 	M
如果 尝试 了 各 种 方法 	T
我 想像 他 正 坐 在 沙发 上 摆荡 双足 	T
本 书 作者 便 是 其中 一 个 	T
让 小 荳荳 有 一 分 我 是 好 孩子 的 自信 	T
修正为 三百三十七 人 至 三百五十八 人 其中 包括 保险司 一百 人 	T
整治 好 城市 的 河流 和 湖泊 	M
硬 件 也 会 变 软 	M
深感 被 房产 开发 公司 欺骗 了 	M
案发 后 开枪 歹徒 骂 了 一 句 脏话 即 坐上 机车 从容 往 抚远街 方向 逃逸 	T
宽阔 的 马路 青翠 的 绿化带 清洁 的 路面 便 跃入 眼睑 	M
把 世界 历史 设想 成 一帆风顺 向前 发展 	M
抢孤 活动 皆 在 八 天 祈安 植福 的 醮事 后 举行 	T
真正 把 自己 的 作风 搞 扎实 	M
海湾 合作 理事会 在 两伊 战争 期间 一致 支持 伊拉克 	T
特别 是 开发 我们 这样 的 油田 	M
报 摊主 现在 甚至 向 这些 报 提出 收取 摊 面 费 	M
苏联 将 准许 德国 空军 于 十二月 十八日 及 十九日 直接 运送 六十 吨 儿童 食品 至 苏联 城市 伊瓦诺夫 	T
要 移师 新落成 的 图书 文献 大楼 	T
公务员 应 遵守 誓言 忠心 努力 依 法律 命令 所 定 执行 其 义务 	T
望 着 李 放 这 副 模样 	M
象征 着 江 泽民 总书记 重 倡 的 延安 精神 和 改革 开放 	M
以及 雕塑家 杨英风 之 子 杨奉琛 做 人工 造景 	T
幸 武松 探望 哥 嫂 路过 景阳冈 	T
并 被 集团军 评为 优秀 党员 	M
第二 次 试举 一百五十五 公斤 及 第三 次 试举 一百五十七 公斤 均 失败 	T
双方 以 四 比 四 呈 僵持 的 局面 	T
损失 及 起火 原因 尚 在 调查 中 	T
他们 希望 看到 堤 上 的 群众 安全 撤离 	M
相信 对 本 中心 所 建造 的 振动台 系统 	T
但 为 了 掌握 工作 状况 	T
是 不 是 我 的 过去 导致 我 在 今天 无法 更 上 层 楼 	T
百分之八十 以上 已经 渡过 了 难关 	M
是 由 男方 送 两 头 活 猪 代表 双双对对 给 女方 	T
其他 厂商 仍 是 有 机会 参与 示范区 的 系统 整合 计划 	T
该市 小 包装 酱菜 买 了 ７０万 袋 	M
如果 将来 真的 没 工作 做 了 	T
对 竹东镇 的 繁荣 将 有 莫大 助益 	T
仅 从 我国 的 电子 工业 而言 	M
两 只 肇事 的 火鸡 却 不 见 踪影 	T
系 依 硬碟 容量 大小 而 定 参阅 下 表 	T
等到 ９时 还 不见 开 窗 	M
一 名 壮年 汉子 在 对 天 起誓 	M
均 未 获 卫生 机关 检验 合格 	T
因此 她 对 建立 政治 联盟 表示 怀疑 	M
李 鹏 总理 一行 此次 满载 中国 人民 对 苏联 人民 的 深厚 感情 访 苏 	M
李 鹏 总理 访 苏 期间 	M
美国 总统 保证 将 尽快 撤出 所有 军队 	M
对于 教育 科学 及 科技 研究 等 方面 的 资源 分享 及 通力 合作 	T
这些 年 来 不过 从 明墓 出土 了 两 张 画作 	T
还有 许多 现代化 的 服务 设施 	M
这次 组阁 困难 的 焦点 问题 是 要 不要 身上 带有 当年 洛克希德 贿赂 案 和 近年 利库路特 贿赂 案 烙印 的 议员 入阁 	M
觉得 错过 这么 一 次 机会 十分 可惜 	M
比如 有 个 厂家 在 皮鞋 的 后跟 上 装 上 一 只 相当于 鞋 钉 的 胶质 旋转 轮 	M
关系 到 武汉 改革 开放 的 大事 	M
政府 又 可以 扮演 什么 样 的 角色 	T
东部 油气 资源 仍然 有 着 很 大 的 潜力 	M
虽 较 去年 同 期 减少 百分之六点七 	T
可以 考据 中国 的 玉器 文化 形成 于 新 石器 时代 中晚期 从 西元 前 六千 到 两千 年 	T
海部 匆忙 赴 美 访问 的 原因 有 以下 几点 	M
直到 近年 才 渐渐 受到 肯定 	T
章 大使 在 递交 国书 时 	M
便 是 学生 自治 的 开始 	T
目前 林姓 业者 平均 一 天 营业额 至少 万 元 以上 	T
还 使 我国 汽车 主 模型 的 设计 制造 技术 跨入 世界 先进 行列 	M
又 将 此 号 以 更 高价 交给 另 一 个体户 	M
该 股 早盘 十点 之前 在 平盘 上 作 狭幅 震荡 	T
就 是 明明 显示卡 及 显示器 都 能 享有 较 高 的 频宽 	T
最 多 时 达到 一百 多种 	M
型 牡羊座 恰 潜伏 了 可能 失败 的 因子 	T
欠缺 对于 显示 的 输出 频率 的 精密 设定 	T
将 传授 这 三 出 戏 演员 的 声部 	T
我们 已 可 稍微 厘出 较为 清楚 之 概念 	T
一 是 姑娘 出席 省 第四 次 人代会 的 留影 	M
而 香港 股市 受到 银行股 获利 增加 的 影响 	T
与 其他 学校 不同 的 是 	T
鞍钢 又 采取 用 国际 国内 银行 贷款 及 补偿 贸易 等 形式 	M
现在 大家 都 在 广场 上 吃 呀 睡 的 	M
黄惠玲 举 了 一 个 例子 	T
金像奖 的 目的 在于 鼓励 创作 	T
执政 的 国民党 似 有 警觉 	T
她们 只好 到 这 简易 工房 来 探亲 	M
尤其 是 罢工 这 种 手段 	T
几乎 每 两三 个 月 就 跳增 一 倍 	T
一直 是 台北 县长 尤清 主政 北县 后 	T
使用 再生纸 是 许多 人 的 环保 习惯 	T
修建 起 一 座 高级 大型 住宅 	M
生化 采样 已经 可以 让 科学家 估算出 畜养 动物 所 能 承受 的 生理 压力值 	T
２２ 家 省市 国营 演出 公司 前来 看 样 定货 	M
河西 检察院 与 无缝钢管 厂 共建 廉政 单位 	M
台北 医学院 医学系 二年级 的 曾丽香 说 	T
二 是 制定 了 发展 规划 	M
然 由 最后 几 个 交易 来 看 	T
首 任 馆主任 是 王志维 先生 	T
但 中华 人民 共和国 及 中华民国 作为 政治 现实 	T
在 今年 第三 季度 始 由 台湾 当局 策划 及 实施 的 冷却 大陆 热 行动 中 	M
家 里 舍不得 卖 的 书 更多 	T
而 不 诉诸武力 或 以 武力 相 威胁 	M
中华 文化 也 一直 在 往 前 走 	T
下午 在 特别 国会 上 履行 了 再次 当选 首相 的 海部俊树 组阁 结果 	M
仍 不得 参加 工会 之 罢工 	T
世界 经济 集团化 趋势 可能 导致 的 贸易 保护主义 加强 	M
已 取消 国家 公营 事业 之 劳资 争议 不 适用 之 规定 	T
仿佛 是 孩子 在 教 我 一些 什么 	T
南部 和 东部 三 个 区域 	T
贵州 家用电器 厂 不仅 在 厂 内 建立 了 一 套 完整 的 售后服务 体系 	M
如 间接 贸易 有所 放宽 等 	M
这 是 与 现代 汉语 不同 的 地方 	T
其实 需要 向 卫生署 申请 许可 的 	T
海水 淡化 厂 的 海水 进入口 ３ 	T
课外 活动组 的 助教 表示 当天 晚上 十一点 以前 最好 不要 有 学生 办 活动 	T
但 卫生署 国际 合作 组 主任 蔡荣福 强调 	T
都 坐 着 衣衫 褴褛 的 灾民 	M
普雷 督促 自己 有 能力 变 	T
两 个 文明 建设 都 要 超过 他们 	M
银行 存款 只 剩下 １０００ 元 	M
这 个 问题 只 要 向 资深 的 同事 请教 就 可 了解 其中 隐情 	T
敬 此 再 祝 吴 所长 及 所 内 各 位 	T
人家 这种 有 远见 的 战略 眼光 	M
对 生产能力 过剩 而 又 无 出口 能力 的 行业 和 企业 	M
为 了 在 国际 市场 上 销售 	T
本 法 于 受有 俸给 之 文武职 公务员 及 其他 公营 事业 机关 服务 人员 均 适用 之 	T
其余 两 岛 的 归还 时期 另行 协商 等 	M
表示 比利时 不 打算 按 北约 的 要求 来 增加 百分之五 的 军事 开支 	M
高 速度 为什么 没有 带来 高效益 	M
企业 如何 才 培养出 优秀 的 管理 人才 	T
是 总公司 制定 的 发展 我国 石油 工业 的 三 大 战略 之一 	M
能剧 讲究 精神 层面 的 严肃性 	T
要 适应 对 开放 的 需要 	M
现场 音 我 同 他们 这样 讲 	M
或是 因 各 案 竞争 激烈 又 演出 一 场 削价 求售 的 流血 战争 	T
网际网路 所 打造 的 新 产业 价值 链 正在 形成 	T
把 这 件 事 告诉 全县 人民 	M
正式 接受 中国 台北 体育 代表团 成员 为 亚运村 村民 	M
而 目前 公司 仍 拖欠 不少 员工 几 个 月 的 薪资 	T
不 是 靠 写 文章 写 出来 的 	M
昨天 发生 在 北 郊区 招待所 的 一 段 佳话 	M
认为 宜兰 民气 仍 可 用 	T
而 沈 太福 连 钱 拿 去 干什么 都 不 告诉 别人 	M
对 闲置 土地 以 标 租 方式 出租 	T
正在 使 它 陷入 越来越 孤立 的 境地 	M
正在 东京 市内 一家 饭店 静养 的 海部 突然 接到 布什 总统 打 来 的 电话 	M
而 即 插 即 用 功能 	T
您 以为 我们 愿意 出来 卖 袜子 吗 	M
那 是 烈士 熊 云清 工作 过 的 车站 	M
但 学校 学童 正 在 上学 期间 	T
当 产生 无法 设定 的 情形 时 	T
即 曾 面临 在 大陆 的 注册商标 遭 日商 申请 撤销 的 案件 	T
绿色 的 黄瓜 条 深 紫色 的 芥 丝 黄 白色 的 萝卜条 	M
应 会 在 最近 开始 寻找 补习班 	T
有 来自 波兰 意大利 日本 等 国 的 ７０ 多种 型号 的 汽车 	M
如果 本地人 能 以 享受 人生 的 态度 	T
中国 又 是 一个 有 着 悠久 历史 和 文化 的 社会主义 国家 	M
成为 世界 麻风病 的 低 发 区 	M
随着 改革 的 深入 开放 的 扩大 	M
澳大利亚 奥委会 主席 戈斯珀 和 墨尔本 的 官员 利用 这 一 机会 向 他 递交 了 该市 申请 的 副本 	M
老师 对 每 个 学生 的 性格 有 机会 深入 了解 	T
三 户 五 家 合成 一 群 	M
由 清华 大学 主办 的 第一 届 大猷杯 桥艺 网球 对抗赛 	T
调动 三 个 方面 的 积极性 	M
杨 绒仙 老人 多 有 福气 	M
现在 就 剩 这 两 毛 钱 了 	M
当年 我 想 是 一 滴水 	M
即可 全然 掌握 各 期刊 之 缺漏 情形 	T
进和 资讯 成为 ＱＣＳ 在 台 独家 授权 的 技术 支援 中心 	T
摆 在 焦 裕禄 墓 前 	M
记者 穿过 充满 礼花 硝烟 的 大街 	M
某 船 船长 黄 先生 向 记者 说 	M
只要 我们 善于 利用 和 发挥 这些 条件 优势 	M
惩治 腐败 与 扶持 正气 相 结合 	M
原来 计划 中 只 征求 １３ 家 至 １４ 家 计划 管理 委员会 厂商 	T
在 中 苏 双方 就 共同 关心 的 国际 问题 交换 意见 时 	M
战士 王 锐 的 父亲 来到 训练场 	M
使用 者 可以 到 网路 上 阅读 自己 需要 的 资讯 	T
成为 相关 业界 寻求 利基 之 重量级 研讨会 	T
我们 应该 借鉴 他们 的 经验 	M
却 形不成 高 质量 的 拳头产品 	M
但 辩称 不 知 其他 同伙 歹徒 身分 	T
实在 委屈 了 大 半夜 扫 街 的 清洁工 	M
在 轻工业 局 的 艰苦 努力 下 	M
其 军事 目标 和 重要 的 政府 机关 大楼 几乎 全部 中弹 	M
增加 欧洲 传统 武力 谈判 的 范围 	T
但 销售 收入 利税 率 却 下降 １６．８９ 个 百分点 	M
在 探索 建设 有 中国 特色 的 社会主义 的 道路 上 已经 掌握 了 许多 规律性 的 东西 	M
没想到 会 造成 这 种 不良 影响 	T
情形 并 不 像 那些 到 北京 的 同学 所 说 的 那样 	M
但是 大部份 资讯 服务业 产值 皆 有 ２０％ 以上 的 成长 	T
假使 对方 关系 真 能 通天 	T
就 能 让 显示卡 送出 符合 萤幕 的 频率 	T
慢性 阻塞性 肺病 主要 包括 肺气肿 和 其 相关 之 慢性 支气管炎 	T
雨 大 了 会 不会 漏 雨 霉变 	M
又 使 一度 被 削弱 的 这 一 政治 制度 恢复 了 它 固有 的 强大 生命力 	M
地震 牵动 着 亿万 人 的 心 	M
是 上 个 月 校方 为 美化 校园 才 设置 	T
不但 要 经 镇 人民政府 审核 	M
它们 的 相互 关系 也 非常 复杂 	M
林汉章 的 书 的确 多 得 数 不 清 	T
雅尔塔 格局 受到 猛烈 的 冲击 	M
期望 未来 能 与 其 扩大 合作 的 范围 	T
该 公司 所 生产 的 药品 	T
二 三 年 前 父亲 过世 后 换 堂兄 骂 	T
砸 的 是 我们 对 产品 质量 责任心 不 强 	M
但是 尽管 小组 成员 如何 指称 	T
资策会 市场 情报 中心 经理 罗泽生 估计 	T
原先 争取 政风室 主任 一 职 的 县府 内部 员工 不 乏 其 人 	T
符合 中 英 联合 声明 精神 	M
他 用 双手 刨 挖 了 一 天 一 夜 	M
以 放射线 而 非 强大 的 爆炸力 杀 人 	T
可是 巨人队 全 场 的 三 支 全垒打 及 密集 火力 却 优于 联队 	T
大堤 安装 爆破 装置 的 那 一端 	M
并 回溯 至 去年 下 半 年 出货 的 产品 	T
我们 且 摘 一 段 他 自述 中 童年 的 一 段 来 看 	T
故 有 将 金融司 改制为 金融局 	T
当 他 被 卷进 政治 诬陷 时 	T
每 一 联盟 内部 各国 可以 单独 进行 	M
以 保持 资本主义 香港 的 经济 竞争力 和 长期 的 繁荣 	M
体育 新闻 免费 提供 选手 职员 来回 机票 与 食宿 	T
牡丹 荔枝 的 娇贵 似乎 一下子 在 饱满 健康 充满 生命力 的 白菜 之 前 大为 逊色 了 	T
张 小姐 告诉 若 想 拍照 	T
其中 一 口 又 因 民众 激烈 抗议 	T
丽正 电子 公司 于 年底 前 将 办理 六千万 元 现金 增资案 	T
亦 将 征询 各 协会 在 九二年 之后 四 年 间 	T
这 种 唯 求 均分 不 重 实务 表现 的 陋习 应 予 袪除 	T
发现 宝城门 刻 有 隧道门 三 字 	T
势必 在 化妆品 业界 引起 轰动 	T
也 可以 发现 其中 不顾 潮流 与 不合 情理 的 干扰 与 障碍 	M
当 记者 在 ４ 连 财务 室 听到 ４８ 岁 的 农工 陈 世昌 领到 ３万 元 的 存款单 和 ６６６６ 元 现金 时 	M
而 师生 关系 基于 理念 结合 	T
对 原本 即已 居于 强势 的 技术线型 有如 锦上添花 	T
因此 它 不 愿 在 关键 问题 上 做出 让步 	M
建设 新 城区 或 改造 旧城区 	M
高县 美浓镇 私立 复新 工商 刘姓 学生 	T
新埔 国中 老师 谢碧霞 在 首日 营队 检讨 时 	T
卢荣 只 同志 家 只有 二 室 一 厅 	M
并 已 邀 各 运动 协会 拟出 各 种 休闲活动 的 企划案 	T
只 卖 给 了 几 个 人 	M
解除 对 联合 民主 阵线 等 ３３ 个 反 种族主义 组织 的 限制 	M
是 心脏 在 不 收缩 所 得 的 压力 	T
还有 的 提出 建立 北半球 合作 带 等等 	M
北京市 各条 战线 的 改革 正 进一步 发展 	M
去年 少年 犯罪 个案 中 每 四 个 人 中 就 有 一 个 是 吸食 安非他命 者 	T
应 让 大中型 棉纺 企业 和 小 棉纺 企业 攀 亲家 	M
才 知道 参加 紧急 会议 的 	M
这个 省 在 计划 安排 上 突出 了 保 农业 	M
意在 使 日本 能 对 世界 新 秩序 的 形成 作出 贡献 	M
全市 城乡 共 放映 １６００ 余 场 	M
在 心理 上 树立 起 应有 的 承受 能力 	M
得手 后 被害人 恐惧 报复 不 敢 报案 	T
一行 人 到底 出 了 村 	M
膨胀 的 库存 堵塞 了 企业 生产 经营 的 良性 循环 	M
也 是 第一 部 电视 连续剧 的 导演 	T
盘中 全然 由 主力股 点火 带动 行情 攀 坚 	T
活动 中 必 会 用心 的 看 问 想 玩 	T
曾 多 次 获得 地方 戏剧 比赛 的 首奖 并 应邀 参加 历年 文建会 策划 的 民间 剧场 亚太 偶戏 展 	T
比 去年 同期 高 出 ２４ 个 百分点 	M
将 会 成为 本 中心 宝贵 的 资料库 	T
希望 就 存在 于 努力 克服 困难 之中 	M
地震 模拟 振动台 建造 工程 进度 报告 	T
避免 了 不必要 的 社会 冲击 	M
有的 单位 下午 还 继续 奋战 	M
可以 在 几 秒钟 之内 到 澳洲 某 个 介绍 保护 动物 的 点 上 	T
但 教学 理念 是 有 改革 的 必要 	T
在 安全 保卫 人员 的 严厉 盘问 下 	M
勘探 开发 的 难度 比 我国 东部 地区 的 油田 相对 要 大 一些 	M
倒是 一些 外县市 的 中小 学生 旅行 	T
庞大 的 军费 开支 已 成为 美国 的 沉重 包袱 	M
变化 就 在 你 的 身边 	M
也 是 造成 美元 和 日元 升 贬 的 原因 	M
挥 起 大 锹 一 串 灰 扬 	M
但 也 是 最多 床位 的 一 幢 	T
路经 小 西 沟 地段 时 	M
这 是 基本法 草案 赋予 香港特别行政区 的 权力 	M
又 对 全场 ７０００ 多 名 承包 农民 普遍 进行 技术 轮训 	M
他 并 举出 窃盗罪 有 七九八０ 件 	T
一定 会 在 日后 开花 结果 	T
服役 的 那 四 年 是 他 大量 读书 的 开始 	T
如果 以 国外 品质 最 好 的 废纸 和 国内 品质 最 差 的 废纸 比较 	T
大约 只 有 四十 位 平民 死亡 一百五十 人 受伤 	T
更 将 把 备份 设备 磁带机 列为 个人电脑 的 标准 配备 之 一 	T
记者 就 这些 企业 的 盈利 自主权 当地 基础 设施 和 优惠 政策 等 １２ 个 问题 	M
几乎 人人 都 会 唱 吴 爷爷 的 歌曲 	T
让 他 决定 将来 要 回 山 上 家乡 服务 	T
无论是 老兵 和 新兵 都 感到 连长 可亲 可敬 可 畏 	M
倒是 前年 在 此 举行 莫内 画展 时 	T
台商 可能 顾虑 中国 大陆 的 企业 本身 没 实力 	T
西宁 地区 已 是 冷风 习习 	M
如何 权衡 得失 利弊 的 取舍 	M
朝着 更 高 的 目标 攀登 	M
不足 之 处 就 由 纸 上 神游 来 弥补 	T
这个 道理 可 算是 老生常谈 了 	M
原住民 也 有 闹 洞房 的 风俗 	T
两 者 是 有 关连 的 	T
交易 仍 在 无声无息 地 进行 	M
并且 其 对 文学 之 美 的 爱好 	T
便 需 些 包 青天 之类 去 平反 	M
对 有的 改革 开放 措施 一时 还 拿 不大 准 	M
针对 这 部分 的 解决 方式 	T
因为 最初 各 系 接受 推荐 学生 的 条件 中 	T
家 里 的 妻子 就 称为 内人 	T
在 华夏 文化 与 世界 文化 之 关系 的 展览室 	T
自从 你 到 那 个 污染 的 地球 那么 久 都 没 回来 	T
为 列名 十 大 枪击 要犯 杨瑞和 手下 	T
世界 各 地 的 博物馆 很少 能 出其右 	T
现在 许多 馆 都 有 新 书 通报 	T
一 双双 乌黑 的 手 向 我们 伸 过来 	M
或许 可以 请 贵 校 核工 的 同学 解释解释 湖 底 污泥 为什么 放射线 测试量 会 很 高 	T
虽 已 有 计划 的 配合 地方 节庆 举办 各 项 活动 	T
在 台北 做 进一步 的 咨商 	T
中 苏 双方 本着 上述 精神 进行 共同 努力 	M
这 １００ 家 外商 投资 企业 均 已 开业 投产 	M
公司 的 小道 消息 也 能 掌握到 	T
职棒 二 年 薪资 调幅 及 缺少 荣誉感 等 因素 影响 	T
加快 改革 开放 步伐 需要 干部 有 个 好 的 精神 状态 	M
在 虎尾 糖厂 招待所 稍事 休息 后 	T
日 苏 两 国 关系 在 １９５６年 建交 后 一直 处于 僵持 状态 	M
一个 致命 的 弱点 是 商品经济 意识 不 强 	M
中共 深圳 市委 常委 扩大 会议 	M
难免 会 给 人 自我 封闭 的 印象 	T
不 发达 地区 和 国家 丰富 的 自然资源 被 源源不断 地 掠 走 	M
一通 未来 可 充当 技术 咨询 的 角色 	T
文大 图书馆 阅览组 主任 林惠敏 答复 	T
缸 内 香油 早已 凝成 固状 	T
中华 奥会 主席 张丰绪 首 次 应邀 参加 这 次 会议 	T
不必 花 大 钱 充 凯子 	T
不 想 跳 农 门 到 外面 找 对象 啦 	M
黄崇仁 在 影像 处理 界 多 年 	T
自古以来 特别 受到 人们 的 重视 和 舖张 	T
几乎 没有 任何 事 是 不 可能 的 	T
术士 认为 这 是 风水 吉壤 	T
从而 埋 下 了 后来 犯罪 的 种子 	M
此 前不久 还 象 皇帝 女儿 一般 的 彩电 身价 陡然 下跌 	M
要 负起 培养 未来 人才 的 责任 	T
邀 四 位 院士 与 该 计划 的 各 实验室 主持人 共同 讨论 	T
全 长 有 二百 公尺 左右 	T
经常 对于 一 个 字 的 平仄 	T
特别 是 当 新 一 轮 改革 开放 浪潮 在 神州 大地 涌起 的 时候 	M
我们 衷心 希望 济南 箱包 总厂 能 早 一点 实现 他们 的 目标 	M
进行 九０ 手枪 的 实地 射击 训练 	T
说 不 出 心里 是 个 什么 滋味 	M
饱受 ７ 个 月 战乱 之 苦 的 科威特 人 	M
黄河 公路 大桥 是 省会 重大 建筑 之一 	M
这个 码头 自 １９８６年 ７月 建成 投产 以来 	M
其 标榜 解 伤 去 郁 助 元气 	T
生产 和 生活 遇到 很 大 困难 	M
因为 这 一 段 小 插曲 	T
这 是 全党 全国 人民 的 共识 	M
我 的 运气 实在 不 好 	T
与 生活 在 地球 上 的 每 一个 人 都 息息相关 	M
日本 社会党 副委员 长久保亘 访问 平壤 时 	T
他 把 韩村 的 代表 请 上 表彰 大会 的 主席台 	M
通过 借鉴 发达 资本主义 国家 的 经济 法律 成果 	M
演戏 还是 主持 节目 都 有 不错 的 成绩 	T
１１ 击败 印度尼西亚 的 洪 忠中 和 罗 天宁 之后 进入 决赛 的 	M
设有 各 种 水 上 游戏 	T
阴平 妈 阳平 麻 为 平 	T
还 飞舞 着 活灵活现 的 石雕 龙头 	M
必须 透过 许多 非正式 的 管道 来 收集 情报 	T
当 好 建设 有 中国 特色 的 社会主义 的 排头兵 	M
韩国 自 １９８９年 开放 国民 旅游 观光 以来 	T
一 名 从 百里 外 赶来 身着 羊 皮袄 的 ８６ 岁 老汉 	M
不知不觉 在 井 下 已 有 １ 个 多 小时 	M
它们 将 各自 的 成绩 归功 于 中国 的 优惠 政策 	M
一 路 上 张 小姐 叮咛 我 	T
村民 是 按 农历 说 的 我们 这里 连续 ２００ 天 大旱 	M
赴 纽约 中华 文化 中心 台北 剧场 	T
以致 不能 建立 以 台湾 为 主体 的 命运 共同体 	T
个人 有钱 则 投向 住房 以外 的 消费品 上 	M
继红 姑娘 羞涩 地 一 笑 说 	M
就 殉葬 了 ４６ 位 妃嫔 	T
更是 引起 赵 海龙 心中 一阵 感慨 	M
开放 的 步子 更 大 了 	M
北约 内部 一直 存在 着 争论 	M
成大 教授 施鸿志 认为 这 并 不 是 理想 的 都市 更新 措施 	T
尽管 全 油田 的 综合 含 水 已 达到 ７０％ 	M
与 美国 经济 看好 相 对照 	M
一 条 七千 年 的 时光 隧道 	T
日前 台湾 証券 交易所 董事会 已经 通过 	T
从而 严重 地 阻碍 我国 经济 社会 的 发展 和 社会主义 现代化 建设 事业 的 顺利 进行 	M
国有 土地 将 只 租 不 售 	T
如 太平山顶 尖沙咀 的 太空馆 及 科学馆 	T
八大 玉山 及 南 二段 路线 者 会 在 玉山 八通关 与 另 一 队 会师 	T
由于 距 各 队 五 位 洋将 登录 截止 在即 	T
只要 发展中国家 根据 自己 的 实际 情况 	M
每 一 项 重大 的 改革 开放 措施 的 提出 和 实施 	M
五十六 公斤 级 韩国队 咸正勋 抓举 一百 公斤 	T
会 的 花色 品种 远 不止 于 此 	M
几乎 都 步上 了 法西斯 的 统治 模式 	T
找到 复古 以外 的 部分 新意 	T
也 和 大 联展 极 不 协调 	M
以往 中国 人 生活 辞典 里 的 粗粮 和 细粮 的 含义 正 发生 着 意味深长 的 变化 	M
山东 的 干部 群众 颇 有 几分 自豪 	M
有 极端 分子 夜间 向 入 城 部队 偷袭 	M
说明 它 是 一 种 统治 怪兽 的 特殊 装置 	T
预料 将 会 掀起 一 阵 购 票 热潮 	T
不但 适合 特定 的 工作 需求 	T
警讯 之后 移送 治安 法庭 审理 	T
警察 逮捕 卅九 名 示威 者 	T
生物 科技 包括 医药 生物 技术 医药 技术 农业 食品 等 四 类 	T
人民日报 记者 张 根国 新华社 记者 王 礼贶 	M
到处 陆续 出现 同 招牌 的 面摊 	T
南港 台肥 工厂 目前 正在 规划为 南港 软体 工业 园区 应 是 颇为 理想 的 规划 	T
电视台 通常 是 敬 鬼神 而 远 之 	T
是 难以 用 金钱 补偿 的 	M
车子 缓缓 地 在 市区 穿行 	M
使 之 成为 适合 青少年 阅读 的 读物 	T
会议 通过 的 决议 文件 指出 	M
立即 率 县 公路 段 运输 公司 的 领导 和 职工 	M
这 就 进一步 明确 了 城市 政府 应该 把 环境 建设 环境 保护 作为 自己 的 主要 职能 	M
这 把 剑 为 人工 冶铁 制品 	T
在 胡适 先生 已经 长眠 地 下 二十八 年 后 	T
收获期 盛期 预估 则 因 天候 无法 配合 	T
我 想 监视 系统 完成 后 	T
解决 住房 苦 乐 不 均 的 问题 	M
曾 在 祖国 名 川 飞 流 上 成功 地 架起 １８０ 多 座 特大型 和 大中型 桥梁 	M
在 市场 竞争 中 抢占 科学技术 这个 制高点 的 	M
切实 保护 企业 负责人 的 合法 权益 	M
还有 人 认为 可能 跌 到 ２３００ 点 的 低点 	M
不仅 早期 诊断 以及 对 疾病 愈 后 的 测定 与 评估 仍 皆 有 其 助益 	T
递给 他 一 根 外国 香烟 	M
形成 了 包括 石油 化工业 各类 加工业 建筑 安装 业 商 饮 服务业 养殖 种植业 等 多 门类 的 经济 结构 	M
使 研发 人员 可以 了解 目前 全球 各 类 学科 的 研发 现况 	T
欧洲 经济区 谈判 始于 去年 ６月 	M
天津市 电影 公司 在 电影 发行 放映 中 	M
新 小妇人 在 美国 既 叫好 又 叫座 	T
努力 争取 企业 晋级 这 都 不错 	M
尤其 怕 领导班子 一 届 否定 一 届 	M
以及 皇家 伦敦 南岸 艺术 中心 主动 的 太极 系列 延展 二 个 月 的 殊荣 	T
肺 弹力 减少 的 速度 比 正常人 为 快 	T
周玉芬 因 波斯湾 动乱 导致 的 世界性 经济 危机 	T
教育部 目前 规定 各 国中 一 至 三年级 均 需 实施 常态 编班 	T
辅大 影像 传播 学系 将 招收 五十 位 	T
在 现场 的 盗采 业者 早已 闻风 逃逸 	T
整 个 治 校 的 方式 	T
八十二点五 公斤 级 韩国 吴炳龙 以 抓举 一百四十五 公斤 	T
也 是 做 学问 的 地方 	T
此 项 结合 资讯 与 通信 的 技术 	T
难道 保持 全勤 就 保证 学生 认真 听课 学 有 所 得 吗 	T
最 明显 的 作法 就 是 	T
我 等 你 的 电话 等 很 久 了 	T
只要 是 做 研究 用 得 到 的 书 	T
长春市 城市 规划 管理 条例 成 了 市 人大 常委会 历史 上 第一 个 经过 两 次 审议 而 未 被 通过 的 地方 行政 法规 	M
雪花 电器 公司 的 ２５１ 升 大 容积 冰箱 	M
仍然 需要 发扬 焦 裕禄 精神 	M
只是 牵涉到 的 层面 有 道德 与 不道德 的 区别 而已 	T
让 一向 习惯于 室 外 比赛 的 选手 有 更深 的 体验 	T
追杀 的 心理 因素 完全 表露无遗 	T
而 比赛 中 的 选手 也 如 舞台 上 的 主角 	T
肯德基 家乡 鸡 在 距 荣华 鸡 仅 数百 米 处 行动 了 	M
我们 还 常常 为 铜陵 七五 的 高 投入 而 沾沾自喜 	M
但 张德培 在 稳住 阵脚 后 	T
我 想 看看 到底 是 什么 样子 	M
帮助 管理 者 一 新 形象 	T
并 没有 很 高 的 学历 	T
只是 中共 对 中华民国 的 国旗 特别 敏感 罢了 	T
而 公司 目前 只 能 以 劝导 方式 	T
防空 警报 又 响 了 起来 	M
或 照理 该 有 如此 结果 	M
地方 政府 及 其 所属 各 机关 	T
一万 多 亩 绿油油 的 秧苗 	M
混凝土 的 配 比 衬 砌 等 各个 环节 反复 检查 测算 	M
虽然 拥有 这些 引人 之 处 	T
我 当 民警 时间 不 长 	M
而 亦 在 其中 的 内埔乡 乡代 黄文瑞 于 不满 之余 	T
外科 手术 不用 针线 缝合 新型 伤口 拉 合 胶布 问世 	M
七十八年 后场 乐师 邱火荣 先生 亦 获 薪传奖 音乐类 个人奖 	T
武汉市 商 委 的 同志 主动 向 胡 平 要 回 了 那 双 鞋 	M
来到 钱 小平 的 车床 前 	M
具有 冒险性 及 刺激性 的 事情 	T
就 包 ６０ 亩 棉花 地 	M
释放 全部 政治犯 之后 才能 取消 制裁 	M
这时候 还 放 不 下 架子 	M
博物院 的 参观 人数 也 显著 上升 	T
在 七五 期间 就 已 开始 实施 	M
除 社会党 的 议席 将 增加 一些 外 	M
委员会 不仅 是 一个 经济 组织 	M
有 些 公司 强调 忠诚 与 信赖 	T
据 杭州市 公安局 刑侦 处 负责人 透露 	M
参与 人数 达 五 六千 人 	T
闯 过 三 天 三 夜 的 惊涛骇浪 	M
职工 们 反映 厂 区 市场 菜价 太 高 	M
院士 选举 在 七月 七日 顺利 进行 生物组 有 八 位 当选 	T
就 一定 能够 实现 油田 的 持续 稳定 发展 	M
这 种 扎根 活动 的 成功 使 反 六轻 积极 人士 极为 兴奋 	T
他 一共 创作 了 一百四十多 首 歌谣 	T
似乎 在 研究 细胞 内 讯号 传递 并 利用 其 特点 阻隔 癌 细胞 分裂 生长 的 论文 	T
逐 家 进行 了 走访 调查 	M
与 军事 有关 的 宇航 开支 高 达 １４１亿 美元 未 算 在 军费 之内 ） 	M
他 一边 听 焦 裕禄 生平 事迹 介绍 	M
所以 他 终于 婉却 了 苏联 戈巴契夫 总统 的 温和 和平 献议 	T
家庭 暴力 因 彼此 关系 不同 而 有 不同 解释 	T
也 有 很多 人 在 各 方面 给 我 很 大 的 帮助 	T
后来 在 游 绍兴 沈园 时 	T
继续 稳定 地 发展 睦邻友好 关系 的 愿望 	M
但 其 理由 并 非 该 商标 属于 著名 商标 	T
认为 单身 条款 没 什么 不 好 	T
总统 好 的 问候声 响彻 校园 	T
也 是 全球 针织机 第四 大 厂 	T
隋 唐 时 则 设 燕州 	T
河南省 考古 人员 最近 在 三门峡 上村岭 	T
在 实践 试验 中 增强 才干 	M
衣服 不仅仅 是 为了 御寒 遮 体 	M
海湾 地区 是 石油 宝库 和 战略 要 地 	M
在 买 之前 货 比 三 家 	T
他 正 联系 承包 一 项 工程 	M
在 新竹县 尖石乡 田埔 新光 两 村 举行 	T
这次 好不容易 抓住 这么 一个 表现 自我 的 机会 	M
我们 的 民主 制度 还 有待 于 完善 	M
甚至 有 恶意 中伤 之 事 发生 	T
这 是 开展 各种 对外 活动 的 一 项 迫切 任务 	M
耐热 和 药品 的 钾 玻璃 等 	T
收盘 时 指数 下挫 １９６ 点 以 ４３８６ 点 作收 	T
最 大 的 断 块 只有 ０．１ 平方公里 	M
解放军 炮兵 学院 名 学员 急 步 赶到 三 河 桥头 	M
使 投资 者 对 香港 经济 前景 充满 信心 	T
已经 根据 县府 等 有关 单位 提出 的 意见 	T
使 美国 的 攻击 十分 成功 	M
是 目前 能 做到 最 适切 的 方式 	T
稚嫩 的 歌声 在 教室 里 萦绕 	M
何以 被 主人 们 前呼后拥 地 奉 若 上宾 呢 	M
引来 了 一 大 堆 村民 围观 	T
但 由于 国内 面临 一些 加盟 共和国 要求 独立 的 问题 	M
其 保存 的 乐曲 可 分 三 大 类 	T
他 向 厂 工会 反映 了 这个 情况 	M
我 觉得 李 厂长 这 一 锤子 砸 得 很 好 	M
这 是 第一 个 引起 争议 的 问题 	M
笑声 中 走 来 一个 衣着 时髦 的 中年 妇女 	M
但 真正 安装 整合 工作 才 开始 	T
没有 稳定 什么 事 都 办 不成 	M
不 听 喝令 的 林玉郎 随即 左 大腿 中弹 倒地 	T
包括 选择 影片 播放 影片 的 时间 观看 时 快 转 倒 带 	T
使得 大盘 回档 的 幅度 应 不 至 太 深 	T
但是 你 通过 手 摸 脚 量 就 感受 到 这个 桥梁 	M
如今 只 剩 古籍 及 外文 书店 	M
当时 妈妈 并 未 告诉 她 被 退学 一 事 	T
１９９０年 两 国 贸易额 为 １８１．８３亿 美元 	M
这 是 党 国家 和 全国 人民 对 特区 提出 的 跨 世纪 发展 的 战略 要求 	M
兰州 第三 毛纺 厂 的 产品 在 国内 市场 一直 是 抢手货 	M
握有 运用 法律 手段 调节 经济 关系 的 优势 	M
他 接着 在 抽屉 里 拿出 一 封 信 递给 记者 	M
昔日 秦 桧 大 禁 野史 	M
也 面临 着 严重 的 环境 污染 和 生态 恶化 的 严峻 挑战 	M
她 要 人 拉 着 架子车 专程 送 她 到 焦 裕禄 坟 前 	M
那么 厂子 与 工商 交通 等 有关 备 部门 事先 打 好 招呼 商量 好 	M
总共 饿死 了 约 两千万 人 	T
北京 人民 在 学期 前期 确实 给 了 我们 极大 的 支持 	M
这 所 学校 共 取得 ４５ 项 重大 科研 成果 	M
将 从 今天 起 售 票 	T
这 项 由 艺文界 首开 先例 二十四 小时 通宵 的 活动 	T
使 他 的 思想 向着 一个 崇高 的 境界 渐次 升华 	M
从 你 呀呀 学 语 起 	M
固定资产 原 值 由 ０．４亿 元 增加 到 １．６７亿 元 	M
藉 多样性 的 计划 来 支持 教育 科学 及 科技 研发 工作 	T
使 海洋 游乐区 的 发展 受到 相当 的 限制 	T
以 最 高 价 的 十万 元 卖出 	T
虽然 切尼 在 访问 中 强调 	M
去年 全 年 平均 总指数 较 前年 上涨 百分之四点一三 的 主要 原因 是 去年 房租 	T
并 提醒 研究生 注意 许多 细节 问题 	T
去 过 那 无拘无束 的 自在 生活 	T
这个 硬 汉子 顾不上 去 挖 妻子 的 尸体 	M
多少 与 其他 部会 未 充分 支持 有关 	T
日本 朝野 各党 均 在 各自 的 党 部 举行 了 出征 式 	M
五台 驻 沙特阿拉伯 利雅得 附近 美军 基地 的 记者 报道 说 	M
亦 有 类似 的 儿时 经验 	T
王海玲 认为 这些 新生代 河南 梆子 演员 乐队 和 编 腔 人才 都 是 飞马 步入 成长期 的 最佳 动力 	T
寻求 设计 制造 推广 一体化 的 新 路子 	M
据说 唐 妈妈 以前 在 报 上 写 文章 时 	T
因为 有的 老师 会 自己 点名 或 不 点名 	T
在 西藏 自治区 第二 届 运动会 上 	M
中央电视台 发射塔 是 为 转播 北京 第 十一届 亚运会 而 兴建 的 	M
都 曾 在 临终 前 嘱咐 蒋纬国 	T
除 破 全 国 记录 者 外 	T
而且 在 医院 和 诊所 的 应用 上 也 相当 实际 	T
不 做 暖身 运动 是 不行 的 	T
其中 包括 召开 中东 和平 国际 会议 的 内容 	M
我 和 大儿子 住 在 一起 	M
基隆 地区 台北县 贡寮 双溪 一带 久 旱 未 雨 	T
使用 者 可 将 ２０６ 内 的 资料 作 放电 处理 	T
美国 篮赛 周日 只 有 一 场 赛事 	T
怎样 促进 有效 的 国际 合作 	M
固阳乡 刁楼村 ７０ 多 岁 的 老农 马 全修 	M
犹 欲 往 扬州 观赏 琼花 	T
亚洲 四 小 龙 明年 景气 都 将 普遍 走低 的 情况 来 看 	T
但是 学 雷 锋 应该 平时 就 表现 出来 	M
二 桥 工程 指挥部 指挥 长 王 燮培 告诉 记者 	M
六日 是 慈安社 这 学期 第三 次 到 安老所 访视 	T
皇岗 边 检 站站长 熊 长根 向 小平 同志 介绍 说 	M
他 自己 却 进 了 监狱 	M
涪陵 地区 不 合格 产品 厂长 会见 闻 	M
关 前 拉回 若 未 破坏 上升 趋势 的 格局 	T
也 影响 了 我们 的 低 目标 的 实现 	M
今年 的 特展 群玉 别藏 也 将 在 此 登场 	T
新加坡 如何 使 学生 有 创意 与 思考 	T
为 思想 和 言论 的 自由 	T
而 使得 全 世界 都 卷进去 	T
对 国家 是 个 难 背 的 包袱 	M
晶晶 肠 火腿肠 取代 了 粉肠 和 猪头 肉 	M
宁愿 背负 只 为 地方 利益 不顾 全民 利益 的 罪责 	T
比 我 在 法国 更 让 我 窝心 	T
在 七 大 类 中 以 教养 娱乐类 上涨 百分之九点五八 涨幅 最 大 	T
要求 党组织 把 我 运 回 兰考 	M
三 天 打鱼 两 天 晒 网 	M
每月 除了 国家 发 的 十六 元 助学金 外 	M
江村罗布 毛 如柏 普穷 江 措 等 政府 领导 与 政府 办公厅 的 同志 正在 小憩 	M
一阵风 把 单元 门 撞 上 	M
但是 在 量 多 的 情况 下 	T
炉灶 对 一 个 家庭 来 说 格外 神圣 	T
已经 不再 适用 甚至 大部分 失传 了 	T
他 于 星期二 从 巴黎 飞往 苏联 首都 	T
去年 订 了 ２０００ 元 的 嫁妆 	M
使得 如何 著手 深 具 规画性 的 传统 民俗 推展 作业 	T
拥有 怀炉 一来 可 用 做 保暖 	T
不会 从 毛发 的 表皮 缝隙 中 渗出 	T
目前 桃园 地检署 协调 台北 荣总 医院 毒物 中心 	T
似乎 缺乏 城市 的 特色 与 区隔 	T
目前 该 中心 也 正 积极 选购 新 的 太空 剧场 影片 	T
这次 又 在 西单 街头 摆开 擂台 	M
做好 的 蟹壳黄 放在 店 门口 	M
缩短 台湾 地区 北 中 东 南 四 个 区域 的 发展 差距 	T
欧共体 １２ 国 总 的 国民 生产总值 今年 已 明显 超过 美国 	M
由于 会议 决定 欧共体 对 政治 联盟 承担 义务 	M
就 枕 在 小 包袱 上 安眠 	M
背上 大娘 就 上 了 车 	M
因此 台证 开办 信用 交易 之初 并 未 沾受 反弹 之 光 	T
一 位 国会 调查员 在 审查 政府 对 伊拉克 销售 的 政策 后 说 	T
台机 自 昨日 起 实施 新 的 退休 制度 	T
是 目前 市场 上 最 新 的 口味 	T
北京 近 郊区 的 用户 冰箱 出 了 问题 	M
按照 国际性 城市 功能 的 标准 	M
４０ 来 岁 的 粗壮 汉子 郑 德全 是 二 队 水上 装 吊 工 	M
三富 周一 跳空 跃上 日线 后 	T
却 也 表露 了 一 个 爱书人 看破 的 心情 	T
媒体 关于 国内 厂商 因 商标 被 大陆 厂商 在 大陆 先行 注册 的 案例 	T
脸 上 也 只有 浅浅 的 一 道 眉线 	T
但是 西德 看来 是 会 提出 停止 短 导 现代化 的 要求 的 	M
为什么 我 买 票 的 那个 窗口 一 天才 拿出 １６０ 张 票 公开 出售 	M
日线 俨然 形成 下档 有利 支持 	T
都 将 同时 与 世人 见面 	T
这次 南朝鲜 保守 势力 的 大 联合 	M
下场 又 坐 到 观众 中 	M
观众 对 演出 报以 经久不息 的 掌声 	M
专研 计算机 理论 及 计算 方法 	T
就 脱 不 了 贪污 受贿 之 嫌 	M
体 教 结合 对 推动 学校 体育 和 竞技 体育 的 发展 可 起到 一箭双雕 的 作用 	M
企业 才能 得到 大踏步 的 发展 	M
另外 计划 向 民间 厂商 募集 新台币 四千万 元 以上 资金 也 十分 顺利 	T
电话 交换机 使用 的 高科技 绝不 比 电脑 网路 差 	T
主要 是 投资 款 可以 随 存 随 取 	M
并 在 部长级 会议 上 提出 了 一些 折衷 方案 	M
抑或 大法官 会议 第二六一 号 解释文 	T
增加 了 粘 即 上下 句 不再 像 律诗 那样 对 	T
泪花 在 每个 人 的 脸上 闪动 	M
笔者 在 沈阳 郊区 一个 卸 垃圾 点 	M
听说 咱 济源 往 郑州 通 飞机 	M
转身 就 去 办 住院 手续 	M
种族 隔离 制度 发起 挑战 的 总统 	M
现今 街谈巷议 最 多 的 话题 	M
也 使 水 难以 在 都市 中 渗透 蒸发 及 保存 	T
看见 胡同口 有 不少 戏迷 等 在 路边 碰运气 	M
勾勒 互动 多媒体 相关 产业 远景 	T
观察家 推测 这 次 会谈 亦 不会 有 进展 	T
且 切 不可 与 他人 共用 针具 煮沸 消毒 针具 并 不 可靠 	T
且 处处 呈现出 遭 挖掘 砂石 后 留下 的 坑洞 及 巨石 	T
把 住房 当作 纯 福利 而 不 当作 商品 的 观念 就是 其中 的 一 种 	M
设有 空调 的 住宿 最佳 的 食物 游泳池 以及 用 荆棘丛 	T
充当 和事佬 说服 美国 业者 接受 多 次 开放 时间 	T
有 一 位 黑 皮肤 的 小 男孩 	M
但 它 并 没有 从 根本 上 触动 种族 隔离 制度 的 基础 	M
同时 并 举行 爱心 义卖 活动 	T
掀起 各 升学 补习班 招生 的 第二 波 热季 	T
我国 在 防治 麻风病 方面 已 取得 令人瞩目 的 成就 	M
全 不见 这 猫 匿 儿 的 名目 	M
是 在 １月 １９日 总统 卫士 和 主要 助手 内弗图内 上校 被 暗杀 后 的 第二 天 宣布 的 	M
１９９０年 华尔街 股市 道-琼斯 股票 指数 将 攀升 	M
精神文明 建设 和 社会 各项 事业 都 取得 长足 进展 	M
目前 她 利用 积蓄 买 了 自家 土地 上 改建 的 房子 	T
而且 恐怕 在 养育 下 一 代 时 	T
这次 欧安会 首脑 会议 首先 是 两 个 大国 共管 时期 结束 的 象征 	M
但是 仔细 深入 比较 县治 迁建 弊案 小组 	T
并 把 金光闪闪 的 一级 英雄 模范 奖章 戴 在 钱 老 胸前 	M
一阵 孩子 的 哭喊 声 从 高空 传来 	M
致使 一些 学校 出现 了 高考 成绩 好 	M
中时晚报 电影奖 刚 开始 举办 时 	T
要 对 妳 自己 有 信心 	T
无轨 火车站 就是 铁路 部门 在 不通 火车 的 地方 设 站 办理 铁路 运输 业务 	M
你 不 喜欢 在 一定 场所 做 固定 的 工作 	T
人们 都 说 世上 只有 妈妈 好 	M
国大 宪研会 的 群魔 乱 舞 	T
坑洼 不平 的 地面 也 基本 平展 整洁 	M
昨天 落网 的 二 名 嫌犯 为 孙健铭 廿五 岁 	T
都 毫无 根据地 诬蔑 为 中国 侵犯 人权 	M
但 实际 运作 的 情形 非常 复杂 	T
四 队 领队 昨天 召开 检讨 会议 	T
表现 了 美国 的 强权政治 的 嘴脸 	M
又 是 唇枪舌剑 的 电视 辩论 	M
比 赞成 同学 的 来得 硬 	T
李 商隐 有 句 诗 夕阳 无限 好 	M
是 用 一 系列 的 制度 加以 保证 的 	M
而 离开 用 马克思列宁主义 毛泽东思想 武装 起来 的 中国 共产党 的 领导 	M
十五日 下午 在 诚品 书店 世贸店 举行 	T
而 不 是 代表 国家 宣读 论文 	T
这 本 白皮书 只 是 阶段性 的 政策 报告书 	T
第一 种子 王莲香 印尼 轻松 以 十一 比 七 	T
两年 前 法国 玛摩丹 美术馆 的 莫内 画作 登台 	T
海洋 公园 面积 约 ７３ 公顷 	T
由于 一通 本身 具备 强大 的 技术 支援 能力 	T
象 清道夫 一样 把 玻璃 擦 得 干净 透明 	M
不能 把 党内 的 批评 和 自我批评 作风 变成 吹捧 和 自我 吹捧 	M
就 不 相信 你 的 损害 自身 利益 的 优惠 能够 真正 落实 	M
这 个 制度 是 要 保护 人类 生物性 的 本能 	T
他 运用 众多 材质 展现 服饰 的 立体感 	T
这次 首脑 会议 是 在 阿拉伯 世界 面临 严峻 挑战 时刻 举行 的 	M
检察院 对 七 项 费用 不 查 帐 不 调查 举报 	M
在场 记者 纷纷 举起 摄像机 照相机 录音机 紧紧 包围 着 这 两 位 对手 	M
现今 学生 涉足 色情 行业 出卖 灵肉 	T
一个 ＯＫ 跳 入 交易 监控 屏幕 上 第二 笔 交易 结果 栏 内 	M
超过 了 英 法 两 国 的 总和 	M
上书 大字 欢迎 您 再 来 ×× × 	M
作者 为 哈佛 大学 中国 历史 及 哲学 教授 	T
它们 经过 磋商 后 决定 ４月 ２８日 在 都柏林 举行 特别 首脑 会议 	M
乃 于 前 晚 九时 许 	T
另 有 一部分 同学 是 来 北京 满足 心愿 的 	M
还 表现 在 其它 工作 与 经济 工作 两 张 皮 上 	M
巴 拉维 ２６日 晚 在 突尼斯 还 同 美国 驻 突尼斯 大使 罗伯特·佩莱特鲁 就 中东 和平 进程 以及 拟议 中 的 巴 以 对话 的 可能性 和 途径 进行 了 磋商 	M
合家 吃 顿 团圆饭 是 百姓家 的 寻常 事 	M
化解 我 的 困难 与 思乡 之 情 	T
老谋深算 的 肯德基 公司 也 在 紧锣密鼓 	M
每 天 所 需 的 冷却 水 是 非常 可观 的 	T
展看 五代 赵干 的 江行初雪 图卷 	T
最后 爬 上 老 坟 岗 的 个人 	M
他们 除了 以 大字报 发表 意见 	T
他们 多少 年 来 在 这块 土地 上 繁衍 生息 	M
正当 老人 呆 坐 在 门口 时 	M
欢迎 有 兴趣 的 鸡年 朋友 报名 参加 	T
而且 最好 每 次 都 与 不同 的 人 出去 	T
日前 已经 获得 国科会 主委 夏汉民 的 承诺 拨款 新台币 四千万 元 支持 	T
如 随地 吐 痰 乘车 逃 票 不 讲 卫生 出口 伤 人 随意 拦 车 等等 	M
裁员 只是 一 种 微调 	M
即使 国家 放松 了 紧缩 力度 	M
但 还是 取得 了 积极 的 政治 和 经济 成果 	M
最 新 １９９４ 全球 高科技 大观 影像 资讯 ＊ 	T
台北 地院 原订 昨 上午 针对 港 台 洗钱 案 绑架 港商 王德辉 部份 进行 宣判 	T
幽默 大师 林语堂 来 台 定居 之前 	T
贴饰 于 前 胸 或 肩档 	T
恐怕 就是 来到 广州 城 了 	M
因为 任何 自欺 都 是 建立 在 某 种 虚伪 与 假象 之上 	T
才 不得不 选 了 这样 的 涌 潮 地区 修 桥 	M
匆忙 赶回 安盟 总部 所在地 然 巴 	M
那 伙 人 中 的 一个 问 高个子 	M
从 我们 这里 看上去 就 像 一 场 令人 难以置信 的 焰火 晚会 	M
是 改革 住房 无偿 分配 的 起步 方式 	M
大概 三五 岁 以上 的 人 全部 会 用 电话 	T
一边 快速 又 熟稔 地 构图 落笔 	T
现在 每天 发售 湛江 经 柳州 中转 全国 各地 的 客票 及 湛江 经 柳州 往 北京 上海 重庆 西安 襄樊 武昌 贵阳 长沙 南宁 等 地 的 客票 ５７０ 张 	M
是 因为 该 课程 时间 与 社会系 必修 课程 冲堂 	T
立即 派员 在 中正路 一三六号 前 寻获 刘女 	T
为期 两 天 的 中共 深圳 市委 工作 会议 结束 了 	M
结婚 仪式 不再 像 以往 那么 讲究 	T
只要 当地 社会 治安 搞 不好 	M
另外 五万 吨 则 予以 外销 	T
由于 国家 的 经济 实力 有限 	M
体总 及 左训 目前 得 依赖 高雄 医学院 及 海军 医院 的 医事 设备 应急 	T
一直 干 到 除夕 前 一日 	M
提供 学员 两性 关系 女性 福利 及 法律 方面 课程 	T
书房 和 餐厅 都 是 大型 书柜 	T
才 是 我们 的 自处 之 道 	T
乔 石 同志 拉 住 身旁 的 焦 守云 说 	M
六 种 手段 无 一 不用 	M
如何 带 好 这些 娇 兵 	M
考试院 于 六月 九日 召开 的 院会 中 决议 	T
并且 已经 采取 措施 释放 １５００ 名 科威特 战俘 	M
如何 当 好 一 名 兼职 工会 干部 	M
也许 她 一直 被 离婚 的 阴影 所 笼罩 著 	T
日本 首相 海部俊树 将 于 ３月 ２ 日前 往 美国 进行 为期 两 天 的 访问 	M
财政 收入 的 增长 幅度 也 居 第３ 位 	M
闻讯 起来 的 两 位 副 乡长 见 老王 劳累 了 一 天 	M
并 经由 国家 高速 电脑 中心 连接 ＮＩＩ 网路 	T
近年来 苏联 国内 的 各种 矛盾 激化 	M
沈阳 的 标准件 厂 铸造厂 低压 开关 厂 等 企业 均 号称 亚洲 最 大 	M
而 优秀 经理人 供不应求 的 亚洲 	T
相传 是 郑成功 时 公元 １６２４１６６２ 随 军民 子弟 带入 台湾 	T
也 为了 尊重 和 保护 群众 的 积极性 	M
不必 在乎 国际 间 对 我们 的 同情 与 支持 	T
而 他 也 兴致 盎然 的 依 言 涂写 著 	T
据说 那 是 因 加温 后 加压 而 使 乳酪 内 的 空气 膨胀 而 形成 的 	T
在 大自然 中 本来 就 有 突变 发生 	T
可以 选择 不 收钱 的 置物柜 使用 	T
平声 多 为 比较 平和 的 词 或 名词 	T
只见 一个 军人 推 着 一 辆 装满 蔬菜 的 自行车 朝 营区 走 来 	M
赫斯特 与 原有 员工 们 也 达成 了 品质 的 目标 	T
矿工 们 兴奋 地 聚拢 起来 	M
科研 成果 过剩 与 生产 应用 技术 短缺 形成 了 鲜明 对照 	M
释放 根据 紧急 安全 法 监 押 的 ３７４ 名 政治犯 	M
是 第一 套 用 在 ＲＩＳＣ 上 的 作业 系统 	T
进 你们 女大 的 门 也 不 那么 容易 	M
在 制造 教师 的 就业 机会 	T
每年 还 出口 ８万 台 发动机 	M
学生 们 渴 了 就 在 这 口 大 水缸 里 喝 上 几 口 凉水 	M
由于 今天 不 看病 上档 后 收视率 始终 不 理想 	T
但 向 下 调整 的 幅度 	T
且 又 具 深厚 的 绘画 基础 	T
就 会 显示 出 它 自身 的 特征 	M
它 最 大 的 特色 则 在 对立 于 传统 士大夫 文人 美学 的 娇弱 颓废 	T
学生 评议会 进行 的 程序 不 对 外 公开 	T
昨天 清晨 七时 许 被 发现 一 具 弃尸 后 遭 焚尸 惨案 	T
集合 二十几 个 表演 团体 及 百余 位 艺文 工作者 	T
心脏病 猝发 而 从此 不 起 	T
这时 李 家 院子 挤满 了 参观 的 人 	M
温室 效应 的 气体 浓度 越 高 	T
每人 每月 卖 一 到 两 箱 袜子 	M
在 世界 新 旧 格局 转变 时期 	M
却 在 通往 菜圃 的 农路 上 发现 被 焚烧 的 尸体 	T
事主 喊声 甫 落 两 名 民警 已 到 飞车 勇士 制服 凶 徒 	M
从 红海 波斯湾 和 地中海 的 美国 航空母舰 也 向 伊拉克 本土 发射 ４０ 多 枚 舰 对 地 导弹 	M
特别 上香 请 神树 不要 出 明牌 	T
趁 着 课间操 后 的 一点 时间 	M
就 能够 提高 储量 功用 程度 	M
这 就 是 齐白石 的 童年 	T
由 国家 环境 保护 局 和 建设部 联合 召开 的 	M
肖 立 的 判刑 是 教育 的 失败 	M
汇集 大陆 考古 资讯 及 文物 资料 	T
国营 长虹 机器 厂 近 几 年 取得 了 不 平凡 的 成绩 	M
每 个 重 约 三 两 	T
我 将 再 来 再 一 次 	T
而 此 次 砂石 弊端 专案 小组 成立 之前 	T
东部 油田 的 稳产 和 增产 才能 有 更 好 的 条件 	M
它 是 我国 政治 制度 的 特点 和 优点 	M
面对 著 这么 一 个 一望无际 赭红色 的 灼热 星球 	T
沈乐满 的 安全 可靠性 和 煤气 燃烧 率 全国 第一 	M
深圳 作为 改革 开放 试验场 的 作用 	M
兰考 的 党 和 政府 抱 定 一 张 蓝图 画 到底 的 决心 	M
大会 预定 当天 下午 三时 卅分 鸣金收兵 	T
难 见到 铜陵 的 商品 广告 	M
因此 显然 行使 公权力 之 人员 与 基于 雇佣 关系 之 人员 在 宪法 体系 是 分开 的 	T
李 院长 远哲 先生 甫 一 上任 	T
这种 冰箱 冷冻室 容积 达 ９６ 升 	M
定 配合 外交部 动作 撤离 沙国 	T
其他 像 不 正确 的 运动 姿势 	T
有人 想 帮 他 调出 铸造厂 	M
以便 所 期望 的 特征 持续 产生 	T
我 也 表达 我们 的 前途 几 项 最 坏 的 估算 	T
今年 夏天 最 热门 的 大事 	T
承担 一千 多 吨 钢 结构 件 和 混凝土 结构 件 安装 施工 任务 的 三 冶 结构 安装 公司 	M
会 先 得到 学生 的 同意 	T
日本 选手 森稔词 也 以 二 比 六 七 比 五 七 比 五 刷掉 第一 种子 赫高提 	T
连 在 文化 中国 的 其他 地域 也 激 不 起 一点 关注 和 同情 	T
你 虽然 眼睛 看 不 清楚 	M
激起 新 一 轮 改革 开放 的 社会主义 现代化 建设 展现 出 更加 绚丽 的 画卷 	M
则 透过 当地 驻外 单位 了解 该 校 学制 	T
近年来 苏联 国内 的 政治 经济 和 民族 危机 不断 加深 	M
建台 水泥 公司 预估 今年 的 产能 为 一百三十万 吨 	T
都 视 公听会 结果 而 决定 	T
我们 应当 作出 恰当 的 估量 	M
昨天 由于 各 银行 大 笔 出脱 多余 美元 	T
这 确乎 是 切中 了 问题 的 要害 	M
未来 大学 将 采取 何 种 入学 方式 取代 现行 联考 制度 	T
人们 多方面 的 需求 和 食品 工业 的 竞争 导致 食品 的 多样化 	M
说 完 推 门 奔 向 工地 	M
它 能够 按照 程式 设计师 的 事先 设计 听命 行事 	T
基金会 里 比较 好 的 书 都 是 林汉章 送 的 	T
可 不 是 现在 的 学生 	T
因此 增辟 限量 流通 的 中价位 路线 	T
医学系 六年级 学生 杨鹏生 当 第六 届 学代 表示 	T
许多 重要 问题 都 没有 深入 讨论 	T
为 女性 及 男性 化妆品 消费者 提供 化妆品 美容 咨询 及 示范 服务 	T
有的 人 对 把 自己 所在 部门 列为 重点 	M
一 座 占地 ４９６９ 平方米 的 大型 住宅 拔地而起 	M
反而 对于 人体 肝脏 有 危害 	T
并且 是 我国 西部 地区 唯一 的 首批 国家 一级 企业 	M
以 高价 轰动 整 个 华尔街 	T
大学生 结合 工运 透露出 什么 样 的 讯息 	T
例如 两岸 人民 都 有 喜欢 移民 的 趋势 	T
法国 和 英国 担心 自己 的 地位 下降 	M
记者 王贵郎 台北 报导 如果 在 本 周 内 水源区 没有 降雨 	T
但 在野党 将 继续 为 迫使 自民党 废除 或 冻结 消费税 而 拖延 对 预算案 的 审议 	M
这 是 监测 工作 的 基本 归宿 所在 方向 任务 所在 	M
就是 为了 刺激 经济 的 发展 	M
当时 这 位 入伍 ２２ 年 的 老兵 	M
即使 看法 相左 也 必须 遵照 不 误 	M
今年 是 治理 整顿 的 关键 一 年 	M
即 资源 短缺 环境 恶化 和 人口 膨胀 	M
情 也 滔滔 水 也 滔滔 	M
就 如何 协调 保护 环境 与 发展 经济 的 关系 	M
平均 年龄 二十七 岁 的 年轻 男性 	T
活动 当时 约 在 学生 中午 休息 时间 	T
共青团员 骆 五一 在 地震 中 失去 了 儿子 	M
其他 演员 还 包括 司马玉娇 许秀年 陈亚兰 等 人 	T
积极 稳妥 地 实施 好 这 一 战略 	M
如今 已 建成 各种 蔬菜 奶 禽 蛋 生产 基地 	M
日 中 贸易 扩大 协议 会 副 会长 水 野 上晃 章 指出 	M
周日 复 以 两 分 力克 连续 两 季 打入 季 后 决赛 的 金州 勇士 	T
作物 面临 高温 障碍 病虫害 等 问题 	T
都 会 把 浴室 擦 干净 才 出来 	T
却 也 有 交融 的 痕迹 	T
一年级 上 学期 的 通识 教育 课程 包含 医学史 概论 生活 规画 法学 绪论 哲学 概论 四 个 单元 	T
而 走 起来 更 像 天女散花 了 	M
上 塔 干活 的 人 也 就 越 少 	M
又 如何 整合出 新 的 产业 	T
一旦 不同 宗教 的 精神 价值 和 性别 族群 语言 地域 	T
几 个 卖 冰糖葫芦 雪糕 的 汉子 	M
长丰县 左店乡 孤堆村 遭 洪水 突袭 	M
也许 很 快 的 就 有 量贩店 专卖店 加盟店 甚至 鱼肉 生鲜 超市 的 出现 了 	T
符合 各国 人民 的 利益 和 愿望 	M
唐语谦 在 这样 一 个 开明 的 家庭 中 成长 	T
神州 大地 的 改革 之 花 正 排 满 枝头 	M
有关 德国 统一 的 协商 不能 限于 两 德 和 美 苏 英 法 四国 	M
开放 天空 的 建议 由 美国 总统 布什 于 去年 ５月 １２日 提出 后 	M
主持人 遂 改为 一 次 ２万 元 递增 	M
且 死者 有 可能 被 击昏 后 	T
深圳 特区 要 发挥 试验场 的 作用 	M
如此 给予 中价位 市场 极 大 的 发展 空间 	T
家访组 则 是 经由 与 当地 居民 的 访谈 接触 	T
从事 广告 行销 的 李慧光 表示 	T
高达 七五％ 的 管理 职位 都 是 透过 专业 人力 仲介 公司 安排 聘用 的 	T
电话 公司 亦 迅速 为 其 装 上 了 电话 	M
最后 一 局 仍 是 不相上下 	T
妳 要 的 是 婚姻 之 名 	T
不 知 其 真面目 为 何 	T
本 都 是 安居乐业 的 有成 国家 	T
有 去 正视 专业 素养 的 机会 	T
到 这 个 地方 不能 把 他们 丢下 	T
杨嫌 并 坦承 有 吸食 安非他命 	T
该 公司 明年 的 第一 个 预售案 将 是 位于 南港 的 住宅 大楼 	T
使 环境 监测 在 环境 管理 工作 中 发挥 更 大 作用 	M
就是 我们 厂部 的 办公楼 何时 盖 	M
技术 要求 要 高 得 多 	M
机械 电气 设备 安装 量 分别 为 ６７１１ 吨 和 ６．１ 吨 	M
北大西洋 公约 组织 和 华沙 条约 组织 的 ２３ 国 外长 将 从 本月 １２日 至 ２８日 聚会 加拿大 首都 渥太华 	M
树立 了 正确 的 人生观 价值观 	M
想到 上 舱 去 找 个 凉快 的 地方 	M
地方 政府 拥有 如此 大 的 自治权 在 世界 上 是 绝无仅有 的 	M
更 注重 生命 中 重要 命题 的 探讨 	T
当 唐语谦 看 过 剧本 后 告诉 唐 妈妈 	T
开发 游艇 专用港 必须 考虑 的 条件 波浪 的 大小 	T
参加 施工 的 数千 名 职工 在 长达 ９ 个 月 的 建设 中 	M
他们 或许 从来不 知道 当 别的 孩子 们 郊游 时 	M
却 被 穿透力 强 的 九０ 手枪 贯穿 	T
皇岗 边防 检查站 海关 动植物 检疫 所 的 负责 同志 	M
先后 向 国家 交纳 税金 ４万 余 元 	M
则 有 电子 精密 化学 技术 开发 等 六 项 计划 	T
前院长 吴大猷 先生 去年 底 曾 表示 	T
黄明晏 已 不 是 马会 的 总裁 	T
扫 街 清 厕 管 治安 	M
它们 在 发展 国民经济 和 保障 人民 生活 方面 有 着 重要 作用 	M
你 换 双 单 鞋 继续 干 	M
一方面 紧 盯 对方 锋线 上 的 几 名 外籍 球员 	M
以色列 为何 向 占领区 大量 移民 	M
我们 都 会 以 完全 的 否定 来 责备 他 	T
我 自己 也 不 清楚 是 不 是 真 爱 他 	T
番禺 县 鱼窝头镇 天益村 农民 专业户 黎 某 	M
尽管 联邦 储备局 今天 已 将 主要 贴现率 调降为 百分之六点五 	T
报名 自 即日 起 至 二月 十日 止 	T
我国 的 环境 监测 工作 经过 １０ 多年 的 创业 和 发展 	M
该 公司 为 免 今年度 水林乡 再 闹 严重 水荒 	T
自己 家门口 的 广告 媒介 也 成 了 外地人 的 天下 	M
许多 低产 果园 收 不 抵 支 	M
浇熄 了 工商 企业家 赞助 体育 的 热情 	T
两 次 集结 现场 酝酿 围堵 施工 	T
总统 当即 宣布 ３月 ６日 为 国家 哀悼 日 	M
沈阳 生产 的 沈乐满 牌 热水器 与 广东 万家乐 牌 热水器 同 为 国家 银牌 产品 	M
企业 靠 什么 求 生存 图 发展 	M
把 广州 社会 秩序 搞 乱 了 	M
为了 开 好 １９９０ 年度 吸尘器 订货会 	M
学生 每 天 平均 花 半 小时 至 一 小时 做 国语科 家庭 作业 	T
九月份 台风 连续 来袭 菜价 暴涨 及 油品 售价 调升 的 影响 	T
包括 六 位 国中 老师 两 位 高中生 及 十一 位 大学生 	T
耐得起 新 战场 的 矢石 交加 	T
但 却 不能 进行 罢工 日本 劳动 关系 调整 法 及 国营 事业 劳动 调整 法 	T
我们 还要 不断 废 骄 破 满 	M
每 一 位 工作 人员 在 办公室 遭受 不 合理 的 待遇 时 	T
可 谁 也 没 亏 过 嘴 	M
这 是 一 个 由 与 一 所 建构 而 成 的 虚拟 商业 世界 	T
并 从 自家 拿出 ３００ 元 钱 ５０ 公斤 粮票 和 两 大 袋 衣服 托 零 陵 行署 专员 专程 送到 这个 组 的 瑶胞 手里 	M
有 林姓 兄弟档 在 树林 开设 海产店 	T
让 使用 者 了解 资料 保全 的 重要性 	T
看 旧 书店 就 知道 一 个 地方 的 文化 水准 	T
阻碍 阿 以 争端 的 最终 和平 解决 	M
优 剧场 将 尝试 以 较 完整 的 戏剧 理念 	T
因 与 被害人 吕传煌 有 财务 纠纷 	T
这样 的 感叹 如果 动人 心弦 	T
这些 符号 在 他 的 心 中 翻转 数 回 后 	T
主管 们 就 决定 每 小时 ３ 美元 的 奖励 	T
文化 教育 卫生 宣传 组织 统战 等 部门 部署 工作 	M
扯皮 扯 了 一 年 半 无 结果 	M
晚上 和 地方 政 农工 商界 领袖 餐叙 	T
灾区 群众 互 帮 互 谅 共 渡 危难 	M
有 那么 多 人 乐意 捐 钱 修 庙 	M
矿车 走 了 两 公里 多 路 	M
你 可能 必须 督促 他们 去 试试 	T
法国 的 建议 包括 两 个 内容 	M
提供 一 个 免于 恐惧 的 生活 环境 	T
盘跌 的 走势 也 使得 持股 比率 高 的 法人 不 甘心 杀出 持股 	T
送件 等 将 公司 成本 降为 最 低 	T
来 看看 玻璃 的 制造 方法 	T
大家 一直 把 解决 住房 的 希望 都 放在 国家 和 企业 的 投资 上 	M
海口 无轨 火车站 的 第一 张 车票 	M
也 会 为 社会 制造 很多 新 的 问题 	T
如今 已 是 辅大 讲师 的 麦 小姐 将 笔名 取为 墀章 	T
湖南省 一些 县 市 的 经验 表明 	M
在 澳门 所 发生 的 故事 	T
以免 误入 一 强弩之末 的 陷阱 中 	T
然 明眼人 却 脱 口 说 出 	M
这 不但 不 符合 我们 所 从事 的 专业 的 精神 	T
提出 了 更 严格 的 要求 	T
走进 电缆 沟 里 检查 质量 	M
你 为 大伙 操 尽 了 心 	M
亦即 她 在 高价位 商品 的 流通 数量 不 多 	T
国内 业务 经理 一 职 将 由 谢仲凯 先生 接掌 	T
新 小妇人 的 导演 姬莲 阿姆斯壮 	T
由于 大学 联考 录取率 的 大幅 提高 	T
在 解决 领土 问题 的 同时 扩大 经济 合作 关系 等 	M
由于 五月 是 跳蚤 繁衍 的 季节 	T
系 上 曾 与 各 班 班代 沟通 	T
这 一 受 人 关注 的 会议 终于 在 波恩 举行 	M
这 ３ 个 在野党 明争暗斗 多于 合作 	M
这次 我市 召开 的 两会 	M
如 前述 公务员 之 范畴 甚 广 	T
为 使 中 日 贸易 不断 发展 	M
１０ 年 来 相继 出现 了 黄 干 白 黑 低度 果 味 保健 等 不同 类型 的 啤酒 	M
令 防守 的 贝尔格斯壮 一时 难以 招架 	T
此后 又 入 了 金人 之 手 	T
分别 以 美 苏 为首 的 北约 和 华约 集团 严 阵 对峙 	M
竞相 购买 济源 到 郑州 的 飞机票 	M
为 实现 总公司 的 这 一 重大 战略 作出 应有 的 贡献 	M
为 抢孤 而 设 的 孤棚架 	T
虽然 这 家 化妆品 业者 强调 男性 美容 艺术 指导 	T
２０时 ３０分 是 约定 的 通话 时间 	M
就 是 字体 印刷 太 小 	T
县上 是 我们 的 一家 之 主 	M
如果 设 在 主管 办公室 旁边 	T
其实 钱薇娟 目前 最 想 做 的 是 大学 体育 老师 	T
曾经 打算 将 企业 的 内部 结构 作 适当 调整 	M
有 人 说 可能 怕 追究 责任 	T
要 获得 增 储 上 产 的 新 突破 	M
自然 科学 包括 化学 物理 等 类 	T
这 是 很 不 正常 的 	M
在 理论 上 是 不 正确 的 	M
一般 世界 上 任何 一个 国家 	M
只能 说明 企业 杜绝 劣质 产品 的 勇气 	M
即使 是 口径 很 小 的 啤酒瓶 可乐 瓶 	M
却 在 牯岭街 的 书摊 花光 了 两万五千 元 退伍金 	T
在 雅尔塔 体制 的 基础 上 逐渐 形成 以 美 苏 两 个 超级大国 为 中心 的 两极 对抗 体系 	M
今后 将 形成 欧洲 的 德国 还是 德国 的 欧洲 	M
建立 欧洲 联盟 将 使 欧洲 国家 通过 与 欧共体 在 文化 经济 以及 共同 安全 方面 的 交流 	M
苏联 东欧 局势 引起 的 国际 资金 流向 的 变化 	M
叶 洪祥 在 大学 校园 里 思考 着 自己 今后 的 道路 	M
慢性 阻塞性 肺病 早期 为 炎症 反应 后 再 生 纤维化 	T
而 我 则 不可 再 犯 	T
为 了 要 使 自己 很 快 的 进入 工作 情况 	T
上线 的 第一 天 只 有 一 个 人 进 资讯站 来 看 	T
虽然 这 车 垃圾 只 捡 完 一半 	M
也 会 使 触碰 者 皮肤 过敏 	T
进而 使 其 占领 巴勒斯坦 和 阿拉伯 领土 的 现状 最终 合法化 	M
如此 公营 事业 上述 三 种 是 以 事业 来 分 则 第四 项 是 以 人 之 身分 来 区分 	T
就 没有 克服 不 了 的 困难 	M
采油 厂长 们 却 为 无法 解决 分 注 堵 水 防腐 难题 而 四处 求援 	M
同时 卅四 国 的 领袖 将 于 一九九二年 再 举行 一 次 欧安 会议 	T
高能 推出 的 产品 都 是 热销货 	M
先 在 一 式 两 份 写好 ㄅ ㄆ ㄇ ㄈ 	T
因此 荣获 同行业 唯一 的 一块 银牌 	M
和 李玉民 又 大吵 了 一 架 	T
对 智邦 大中华区 的 业务 通路 策略 市场 方向 将 会 带来 新 的 转变 与 作法 	T
于今 与 振动台 有关 之 界面 	T
不 排除 下 周 继续 以 滚 大量 方式 以 达 拉高 出货 的 目的 	T
此外 他们 又 总结 出 继 发 性 完全 型 截瘫 的 新 类型 	M
这 并 不 意味 着 我们 将 拒绝 向 任何人 出售 任何 东西 	M
他 又 赶回 刘 帅 家 报 了 信儿 	M
他 去年 十一月 至 沙国 时 	T
即 中 日 贸易 迎来 了 转机 	M
电力 的 供应量 已 呈现 不足 的 现象 	T
千难万难 难关 难 在 资金 上 	M
政大 生辅组 负责 宿舍 业务 的 教官 唐辟洲 表示 	T
与 露天 展出 的 各 国 大师级 雕刻品 闻名 于 世 	T
现在 小 刘 帅 转 到 北京 儿童 医院 治疗 	M
在 副 矿长 焦 绪文 的 引导 下 我们 乘坐 ２０ 分钟 的 罐笼 车 	M
因为 自己 的 生活 不 一样 	T
汇编 中 各 专利 之 内容 简介 摘 自 专利 说明书 	T
１０ 人 以下 迷你 巴士 Ｒ２０ 	T
孩子 自由 落体 坠 向 地面 	M
神座 之 前 各 有 香炉 一 烛台 二 花瓶 二 	T
争先恐后 地 把 学习 用品 小 玩具 等 生日 礼物 递 到 她 的 手上 	M
在 改革 开放 的 道路 上 阔步 前进 	M
体 弱 的 小朋友 会 因为 血液 循环 不良 而 昏倒 	T
虽 不 是 展览场 上 的 常客 	T
从 法律 政治 社会 各 个 层面 分析 台湾 妇女 所 面临 的 问题 	T
但 过去 二十 年 的 经验 	T
设立 三 座 电脑 晶片厂 的 投资 计划 	T
正在 地处 竟陵 闹市区 的 农行 天门市 支行 中心 储藏 所 内 	M
连著 几 记 强有力 的 穿越球 拿下 几 局 	T
不 喜欢 别人 闯进 它 的 内在 世界 	T
昨日 正式 宣布 已 取得 本 国 中央 标准局 商标 注册証 	T
且 采取 下 一 步 行动 	T
却 在 工地 上 送 走 蛇年 	M
获得 英国 民众 媒体 艺评 的 高度 好感 	T
学生会 唯一 担心 过渡期 会 造成 社团 运作 的 不 顺畅 	T
省 农业 部门 计划 １９９０年 全省 茶叶 产量 恢复 到 １６５万 担 	M
就 会 有 古董 旧书 流出来 	T
其实 也 就 是 帮助 自己 适应 生活 	T
执政 的 自民党 试图 在 国会 通过 联合国 和平 合作 法案 	M
并 向 教育部 提出 签订 两 国 体育 交流 计划 的 要求 	T
盲目 抢 上 的 后果 开始 呈现 	M
如果 说是 因为 取证 困难 	M
委托 主任 会议 听 一 次 汇报 	M
找到 了 通往 明楼 西侧 的 砖 隧道 	T
这 五 种 物质 所 制造 的 温室 效应 强度 均 不 相同 	T
中共 外长 钱其琛 在 离开 北京 前往 纽约 前 告诉 记者 美国 新闻界 的 报导 	T
卫生署 国际 合作 组 主任 蔡荣福 表示 	T
而 苏联 最近 提出 的 东西方 在 １９９５年 完全 撤走 驻 外国 的 军队 的 建议 	M
海湾 危机 更是 矛盾 多 端 	M
傅国强 在 第三 局 最后 一 球 腿部 抽筋 救 球 不及 	T
代表 不同 利益 集团 的 国会 议员 之间 必将 有 一 场 严重 的 较量 	M
多 上交 国家 用于 补贴 文化 事业 经费 ３７．８万 元 	M
不 是 不顾 条件 的 蛮干 	M
建 于 十五世纪 明成祖 永乐 年间 	T
另外 饰演 祝英台 的 女 主角 	T
无疑 是 双重 的 致命 打击 	M
高档 果然 不少 获利 回吐 及 解套 卖压 出笼 	T
傍晚 行路 不至于 就 遭 打劫 	M
苏联 最 迟 可 在 １９９１年 底 全部 撤军 	M
在 １１５ 天 的 紧张 施工 中 	M
还 将 多层次 多渠道 地 拓宽 合作 领域 	M
立式 加 了 ３ 个 抽屉 	M
于是 用户 都 转而 去 买 乡镇企业 生产 的 寿命 短 但 价格 低 的 产品 	M
广大 发展中国家 的 生态 破坏 之所以 严重 	M
墓葬 中 还 首 次 发现 结构 完备 的 玉饰 	T
比 去年 同期 增长 ２３％ 以上 	M
而 国内 的 总投资 为 八十四亿 元 	T
大 个 的 苏联 汽车 专家 比力亨 	M
自 年初 以来 均 以 观望 态度 因应 之 	T
整个 电视塔 将 向 世人 亮相 	M
在 艰苦 生活 中 人 与 人 之间 的 互 爱 互助 	M
今年 三四月份 又 被 调 回 收费站 	M
规模 大 使得 经济 规模 更 具 效益 	T
主张 必须 要 有 一 股 抗衡 的 力量 	M
绝不 是 为了 废除 种族 制度 	M
企业 往往 能 找到 优秀 的 人才 	T
要 把 这些 方针 政策 和 措施 真正 落到实处 	M
沈 太福 便 想到 了 海口 的 歌舞厅 	M
下面 的 班子 谁 还 闹 摩擦 	M
推行 了 这 两 项 有 意义 的 活动 	T
原 是 临 大路 的 一个 村庄 	M
新 当选 的 总经理 宋 鸿柏 清楚 地 意识 到 承包 仅仅 是 所有权 与 经营权 的 分离 	M
更 要 发动 群众 提 合理化 建议 	M
山西省 铁路 部门 积极 挖潜 扩能 	M
开始 算清 了 为 那 九十万 斤 粮票 他 应 付出 的 巨大 代价 	M
那 为 啥 现在 还 没 维修 好 	M
其 天职 是 为 人民 服务 	M
才 可能 集中 适当 力量 加快 西部 地区 工作 	M
由于 基隆港 外海 的 风浪 六 到 七 级 	T
干员 首先 在 中正路 四０一号 七楼 之十五 查获 少年 谭杰 十七 岁 	T
防汛 是 每 位 市民 的 应 尽 职责 	M
则 已 是 不 争 的 事实 	T
至于 今年 要 邀请 日本 那 一 支 职棒 来 华 	T
佛教 更 是 外来 文化 的 一 大 冲击 	T
有 两 个 在 本县 工作 	M
困 皮 根本 不 可能 有 任何 画面 	M
一个 青年 妇女 来到 乔 石 面前 	M
持 别 是 少数 领导 干部 	M
制止 滥发 各种 奖券 的 现象 	M
国内 篮球 幼苗 的确 年年 表现 十足 的 潜力 	T
使 公害 防治 小组 成员 面对 满目疮痍 的 河床 感到 痛心 	T
他 对 陵园 工作 人员 说 	M
馆 内 除了 展览 物品 之外 	T
走 不 上三五 步 就 又 被 人 围 上 	M
纷纷 向 证券 柜台 工作 人员 索要 １９９０年 国库券 个人 认购 缴 款 单 	M
南非 当局 的 这 一 积极 举动 在 国内外 受到 广泛 欢迎 	M
甚至 产生 冷战 后 历史 已告 终结 	T
二氧化碳 占 了 大气 中 的 ９６．５％ 	T
我们 要 怎样 建立 一 颗 平常心 呢 	T
陈金茂 在 职棒 元年 球季 结束 的 打击率 为 二成 九五 	T
院士 会议 后 七月 八日 九日 为 吴 前院长 荣退 学术 演讲会 	T
年产 ８０万 吨 优质 薄板 的 现代化 冷 连 轧 机组 轧 出 了 一卷卷 优质 薄板 	M
我市 的 反 腐败 斗争 一定 能 取得 预期 的 胜利 	M
他 是 要 采取 极端 主义 	T
台风 登陆 的 方向 与 次数 	T
就 成 了 第７ 轮 谈判 能否 圆满 成功 的 关键 	M
所以 你们 要 经常 下来 跑跑 	M
民国 初年 仍 设 都 于 此 	T
又 步行 了 近 ２ 公里 的 坑道 	M
也 是 军事 理论 的 较量 	M
其它 不 押韵 的 句尾字 有时 是 句 首 	T
为 使 此 类 研究 成果 	T
探明 时间 要 长 得 多 	M
拥有 多 年 实际 艺术品 拍卖会 经验 的 苏富比 	T
由于 一般 老鼠 不 够 干净 	T
此 一 作业 系统 的 推出 	T
野莺 的 雄 鸟 喉部 是 一 片 的 鲜红色 	T
解决 了 锦纶 丝 水分 较 大 的 问题 	M
阿沛 副 委员长 走 出 档案馆 	M
而且 韵字 有 一定 的 平仄 	T
运用 教学 录影带 声音 训练 和 穿 衣 风格 指导 等 工具 	T
所属 擅 离 职守 时 即 可能 受到 公务员 惩戒 法 	T
形成 左右 对称 的 气流 循环 	T
目前 武汉 长江 大堤 的 总 长度 比 １９４９年 增长 近 两 倍 	M
在 世界 格局 发生 重大 的 转折 性 变化 之际 	M
另一方面 帮助 农村 乡镇企业 调整 产品 结构 	M
省 农行 通过 对 全省 乡镇企业 进行 全面 信用 等级 评定 	M
他 还 将 会晤 联合国 秘书长 佩雷斯·德奎利亚尔 	M
甚至 在 全 程 出现 不少 民众 问候 郝 院长 新加坡 之 旅 累 不 累 这 类 温馨 镜头 	T
这儿 的 工作 比 托儿所 难 做 	M
因此 见 诸 文字 者 尚 不 多 	T
就 要 付出 高成本 的 建设 费用 了 	T
那么 文化 意义 的 中国人 也 就 是 广义 的 华人 面对 一 三 五 七 九 的 论说 应 如何 自处 呢 	T
是 即刻 可以 把 台湾 的 处境 推向 危险 的 悬崖 之 上 	T
纷纷 涌 向 作为 科威特 象征 的 大 塔 附近 的 海湾 大道 	M
除 鞍山 本溪 盘锦 三 市 固有 鞍钢 本钢 辽河 化肥 厂 三 个 盈利 大户 支撑 外 	M
曾 用 两 年 多 为 党 培养 了 近 千 名 妇女 干部 	M
很 显然 上述 各种 力量 是 不同 的 	M
经济 发展 曾经 居 全国 前列 的 东北 三 省 近年来 工业 生产 步履维艰 	M
有 多少 市民 和 过往 旅客 要 乘车 乘船 南 行 北 往 	M
除了 店 里 摆售 的 书 外 	T
订婚 大多 以 喜饼 代替 猪只 	T
有 三 项 快速 发展 且 深 具 影响力 的 力量 进入 了 商业 的 竞技场 全面 品质 管理 新 技术 及 劳工 多元化 这样 的 工作 重组 方法 都 需要 较 高水准 的 语言 数学 及 推理 技巧 	T
傅国强 以 十五 比 十三 获胜 	T
引导 群众 认识 安定团结 的 重要性 并 付 之 行动 	M
要 根据 我们 的 任务 和 目标 	M
以 满足 消费者 比 上 不足 	T
黎 某 在 天益村 所 建 的 私人 住宅 	M
两者 之间 的 期限 为 一 年 	M
人们 是 会 感谢 他们 的 	M
并 责令 银行 采取 各种 灵活 有效 的 手段 搞活 储蓄 	M
这种 放松 银根 政策 的 目的 	M
但是 我们 学 雷 锋 的 时候 要 学 他 的 精神 	M
不要 看到 别人 赚钱 就 眼红 	M
反而 能 发挥 杰出 的 能力 	T
林嫌 因 慌张 而 机车 倒地 	T
但 由于 电子 信息 技术 的 落后 	M
除了 以 幻灯片 介绍 泰雅 文化 教唱 最后 一 天 晚会 要 表演 的 山地 歌舞 和 学习 泰雅语 	T
连结 时 与 本 端 使用 者 有 相同 的 执行 功能 	T
一 海湾 战争 结束 美国 人 消费 和 投资 由 消极 转为 积极 	M
一个 拾 起 地上 的 一块 砖头 	M
安盟 主张 停火 日 要 同 大选 日 相 联系 	M
十一日 南韩 官员 北上 至 平壤 第二 次 会谈 时 	T
该 城市 民 及 人大代表 不堪 其 苦 与其 辱 	M
只好 来 找 你们 消息 灵通 人士 打听 打听 	M
他 又 从 北京 长城 公司 集资 部 提 １００万 元 	M
经 查证 失踪 之 闽平渔 五一二九 	T
在 与 日 美 竞争 中 曾 造成 经济 上 很 大 的 被动 局面 	M
加州 一些 经济 预测 专家 指出 	T
一边 扫 着 地上 的 积水 	M
持续 了 １４ 年 的 安哥拉 国内 战争 	M
又 用 刀 逼迫 事主 拿 钱 不遂 被 人 穷追 的 	M
献给 党 的 好 干部 焦 裕禄 同志 	M
移 至 该 处 弃尸 焚烧 	T
盼 另 辟 路线 兴建 快速 道路 	T
似 春雷 在 心头 滚 过 	M
使 生医所 能 发展到 正式 成所 	T
但是 我 永远 也 忘不了 老师 同学 和 周围 的 人 给 了 我 妈妈 一样 的 爱 	M
内地 的 社会主义 现代化 建设 不但 为 香港 提供 更 多 的 投资 机会 	M
辽宁 人 不 善于 把 奖牌 变为 名牌 	M
只 图 卖 选票 的 戋戋 之 数 	T
人们 还 提出 这样 一个 问题 	M
一些 从 京 返回 的 同学 把 一时 一 地 的 现象 当成 整体 形象 了 	M
谁 要 撅 折 一 根 树枝 	M
新竹 县议会 在 本 届 第二 次 定期 大会 中 成立 的 调查 县境 及 河川 采掘 砂石 弊端 专案 小组 	T
是 世界 人民 面临 的 一个 重大 课题 	M
一 位 护士 正 为 坐 在 藤椅 里 晒太阳 的 病人 洗 脚 	M
妇援会 希望 这 项 活动 能 深入 各 社区 及 团体 	T
昨晨 在 彭佳屿 附近 查获 企图 从事 海 上 交易 的 五 艘 大陆 渔船 	T
本报 许多 读者 也 认为 应该 讨论 一下 长虹 现象 	M
王扶林 认为 实际 上 在 电影 	T
双方 还 在 自由 使用 渔业 资源 货车 过境 运输 建立 协调 发展 基金 等 问题 上 存在 着 比较 严重 的 分歧 	M
在 船上 点 亮 了 所有 的 信号灯 标志 灯 探照灯 	M
深信 中央 和 省 能够 赋予 特区 更 大 的 试验 权 	M
他 前 住 市政府 信访 接待站 	M
各种 门类 的 科技 人员 和 专门 人才 相对 较为 齐全 	M
我们 完全 有 信心 继续 走 在 全国 改革 开发 的 前列 	M
甚至 因为 许多 临时 加入 演出 的 团体 使得 节目 爆满 	T
引擎 的 排气量 是 ９００ ｃｃ 	T
因而 花 在 以上 两 项 的 费用 将近 五万 元 	T
祥 云 国货 精品 商场 创立 的 初衷 是 为了 弘扬 民族 精神 振兴 民族 工业 	M
一般 上班族 的 主力 餐盒 为 六十 元 左右 	T
彩电 成为 我国 市场 上 最 紧俏 的 商品 	M
造成 地球 表面 温度 上升 的 现象 	T
他 已经 要求 代表会 主席 林保漳 代为 邀请 全体 代表 聚会 	T
其 下 分为 六 组 各别 处理 金融 政策 与 制度 	T
伊拉克 至少 还 需 数 月 才 能 造出 一 枚 简陋 的 核子 武器 	T
五 厂长 经理 按 规定 比例 提出 业务 活动 基金 的 支配 费用 	M
为了 肩负 起 这个 新 的 历史 使命 	M
过 一 种 轻松 的 生活 	T
购物 在 尼泊尔 是 一 大 学问 	T
你 甚至 丧失 对 自己 的 信心 	T
既 固定 保护 水草 的 根 	M
在 身心 方面 应 尽量 求 其 平衡 平静 	T
条约 的 最终 签署 还 面临 着 不少 困难 	M
在 汽车 离开 该县 市 时 	M
此 事 已经 获得 省主席 宋楚瑜 的 重视 	T
其中 的 四十九 个 打点 及 六 支 全垒打 在 队 中 都 是 排名 第二 	T
收费 及 配送 成 了 最 大 的 挑战 	T
余 女士 某些 有关 改善 此 一 缺失 的 提议 	T
夜晚 突然 一 阵 狂风 袭来 	T
且 听 南轧 厂 厂长 丁 国良 的 回答 	M
也 因此 ＷＷＷ 网路 在 两 三 年 内 会 更加 的 盛行 	T
旅馆 业界 及 各 观光点 应 加速 计划 开拓 韩国 旅游 市场 	T
竞争 对手 如林 的 情况 下 不 是 件 容易 事 	M
黑松 公司 撤销 对方 的 商标 专用权 	T
每 年 颇 引人注目 的 国防馆 	T
好 眼睛 也 变 近视 了 	M
竟 没有 发现 一 件 完整 的 物品 	M
否则 不可 对 外 透露 评议 内容 	T
东海 社会系 教授 黄金麟 日前 发起 全 校 联署 声明 	T
唐 启文 负责 施工 的 项目 不 下 几十 个 	M
但是 却 住在 非 人性 的 环境 里 	T
但 企业 的 领导者 也 要 有 群众 观点 	M
若 能 克制 内在 激动 的 情绪 	T
在 主从 架构 的 伺服 端 	T
会 让 员工 们 感受到 这 是 工作 中 重要 而 持续 的 一 部份 	T
关于 这个 议题 本次 会议 做 原则 通过 	M
由于 苏联 对 西欧 不再 构成 威胁 和 华约 实际上 已 瓦解 	M
亦 可 拥有 祈福 航海 平安 的 顺风旗 	T
整 个 国家 实际 上 有如 一 个 巨大 的 冰窖 	T
工业 巨人 步履 蹒跚 行动 迟滞 的 反常 表现 	M
而 一 交通部 官员 则 指出 	T
积压 着 １８万 辆 自行车 ７２万 只 手表 １．２万 台 冰箱 	M
祝 第四 次 全国 环境 监测 工作 会议 召开 	M
而 这 座 桥 却 是 在 桥墩 上 先 浇 一块 零 号 块 	M
再 由 各 大学 自订 入学 考试 方式 	T
因 价格 是 依 少女 年龄 	T
并 于 垃圾场 内 捡拾 破烂 	T
由于 上海市 演出 公司 经营 方针 明确 	M
同时 企业 经理人 对 未来 三 年 内 的 政局 安定 有 百分之七十一点六 	T
在于 前者 必须 广泛 参加 高中 的 各 种 活动 	T
笼统 地 表示 支持 也 无 不可 	M
唐 妈妈 从事 幼教 工作 十八 年 	T
没有 理由 忽视 学生 权益 的 	T
袋 内 有 几 条 鱼 	M
但 南 一段 路线 全程 可能 有 两 天 缺 水 	T
也许 这项 工作 会 遇到 许多 困难 	M
未来 若是 法人 机构 持续 观望 	T
这次 组阁 在 哪里 卡壳 了 呢 	M
大 联合 应 以 实施 内阁制 为 前提 	M
面带微笑 地 对 周围 的 人 说 	M
但是 台湾人 成功 的 保留 人 与 人 的 关系 	T
那么 这些 基于 私法 关系 聘雇 之 公务员 和 基于 公务人员 任用 法 所 任用 之 公务人员 截然不同 	T
为 今后 顺利 执政 清除 障碍 	M
地方 也 应 从 全局 着眼 	M
从 过去 一连串 相思林 运动 邮政 总局 及 农 牧场 事件 	T
中国 科技 大学 在 世界 科技 前沿 频 结 硕果 	M
有的 则 将 刚 领 出来 的 钞票 仔细 地 清点 着 	M
两三 下 便 制服 了 顽 凶 	M
并 指摘 抢 注 的 公司 不当 	T
可 苏州 新 艺 鞋 厂 的 专利 产品 	M
略 低于 更 前 一 年 七十八年 的 百分之四点四一 	T
我们 只是 要 读出 我们 自己 制造 的 资料 上 的 名称 而已 	T
本 书 将 向 读者 证明 	T
但 仍 有 局部 偏远 及 高地 地区 还是 供水 上 有 困难 	T
对 面临 的 变革 有 较 强 的 承受力 	M
主要 是 藉著 一 条 可以 发射 无线 电波 的 金属线 	T
难道 还要 让 滔滔 溪水 白白 流淌 么 	M
他 就 得到 不少 有识之士 的 拥戴 	T
担负 着 甲苯 乙甲苯 甲醇 硫酸 等 化工 产品 的 卸车 装船 及 两 种 丙 类 危险 液体 产品 卸 船 装 桶 储存 的 任务 	M
爆炸 主要 在 巴格达 的 周围 大概 二十 至 四十 公里 的 地方 	M
把 对外 开展 的 各种 形式 的 活动 推向 一个 新 的 更 高 的 阶段 	M
压倒 了 风声 雨声 浊 浪 击 岸 声 	M
中国 青年报 记者 马 应珊 新华社 记者 孙 宁海 党 周 	M
金 银牌 一直 青睐 着 辽宁 	M
陵园 建 于 １４０９ 到 １６４４年 	T
五年制 的 新庄 农校 职业 学校 毕业 后 	T
词 的 魅力 是 与 词 的 声韵 分 不 开 的 	T
计划 提供 如 电玩 医疗 保健 旅游 越洋 电话 房地产 等 生活 资讯 	T
同 美国 的 暗 地 支持 不无关系 	M
到 北京 后 吃 穿 如何 不用 愁 	M
也 看到 了 她 沧海桑田 的 历史 	T
不少 工厂 采购 人员 都 不 敢 出差 了 	M
及 依 雇员 管理 规则 进用 之 雇员 	T
由 几百 台 东风 和 卡码兹 汽车 组成 的 中 苏 边贸 运输队 	M
就 在于 １０ 年 来 我们 党 和 政府 在 不断 地 适宜 地 推进 多方面 的 改革 	M
中国 国际 信托 投资 公司 意向 买进 中国 新 技术 创业 投资 公司 ５０万 元 面值 的 １９８９年 国库券 	M
参院 和 众院 分庭抗礼 的 局面 仍 会 继续 	M
那 自行车 在 布满 碎 玻璃 碴 和 图钉 的 地上 来回 走 	M
更 能 在 他们 知道 自己 成绩 之余 	T
创造 出 几 倍 于 当前 的 国民 生产总值 	M
昨天 在 西滨 公路 凤坑 隧道 和 附近 已经 舖上 砂石 级配 的 路段 	T
只有 敢 怒 而 不 敢 言 的 份 	M
关于 安盟 领导人 萨文比 未来 去 从 的 安排 	M
许多 干部 职工 是 看 了 黄牌 以后 	M
被 列为 优先 考虑 的 制作 单位 	T
并且 由 县 国土 局 办理 用地 手续 	M
冰箱 噪音 降 到 ３６ 分贝 	M
共同 就 中国 人口 有关 问题 相互 研讨 	T
回顾 和 讨论 了 国际 上 已经 签署 的 国际 法律 文书 的 实施 和 执行 情况 	M
南轧 人 的 取舍 观 将 作为 产业 结构 调整 中 出现 的 一 种 新 的 思维 方式 引起 人们 的 关注 	M
才 可以 结合 其它 地理 资讯 作 更 进一步 之 使用 	T
比如 你 要 让 人家 兴旺 	M
那么 一个 先进 的 联合 企业 则 是 一 只 凤 	M
使得 这 两 项 开发 计划 跃上 生态 环保 议题 焦点 的 	T
这 是 件 非常 有 意义 的 事 	M
多极 局面 是 逐渐 形成 的 	M
而 林汉章 是 少数 专业性 的 老板 	T
数十 盏 矿灯 聚集 的 光束 	M
因为 教授 本身 具有 利害 关系 	T
机电部 一 位 领导 同志 曾经 指示 	M
几 个 初中 一 年级 的 学生 说 	M
该 公司 上 半 年 的 营业 利益 一亿四千五百万 元 	T
凡 演员 无理 索要 高额 报酬 的 也 不 演 	M
命 先 拆毁 山野 荒田 中 的 寺院 及 修行 道场 	T
可 在 后方 撞击 车祸 中 发挥 功用 	T
生产过剩 的 多 属于 劳动密集型 产品 	M
共同 应付 日趋 复杂 的 国际 经济 大 竞争 	M
目前 则 大致 维持 在 三十 至 三十五万 张 的 水准 	T
丢 下 一 地 的 垃圾 不 打扫 	M
自此 即可 窥见 华隆 集团 全面 作多 的 时刻 尚未 来临 	T
少 部分 为 善心 人士 所 捐赠 	T
却 要 攀登 军队 现代化 建设 的 高峰 	M
张丰绪 若 能 继续 当选 连任 中华 奥会 主席 	T
便 以 建 村 砖 厂 办公楼 为名 修建 的 	M
登记 参加 今日 投 的 有 ２２ 家 企业 和 个人 	M
南方 为 北方 的 富裕 作出 了 巨大 的 贡献 和 牺牲 	M
希望 能 拉回 部分 误买 水货 的 顾客 	T
不 是 电脑 原件 中央 处理机 记忆体 周边 设备 之间 互相 沟通 	T
而 海珊 的 筹码 愈 多 	T
他 却 感到 许许多多 新 的 不满 	M
因此 就 公营 事业 而 言 可 分为 三 种 类型 	T
比照 其他 县市 如 彰化县 另 辟 路线 施工 	T
巴解组织 驻 突 代表 同 苏 大使 会谈 	M
虚伪 本身 就 是 一 种 道德 上 的 纵容 它 是 对 美 和 忠诚 的 一 种 仿冒 	T
他 能够 抵制 花花世界 的 诱惑 	M
黑龙江省 鸡西市 调查 队 对 其 当地 的 １８ 家 国营 商业 和 供销 合作社 零售 企业 做 过 调查 	M
从 黑人 居住区 撤出 一切 军队 等 	M
然 翻 遍 所有 现在 和 过去 出 的 辞书 	M
日本 不仅 在 加速 走向 政治 大国 	M
我们 每 ２０ 天 只能 买 ３０ 公升 汽油 	M
第４５ 条 建议 虽然 流产 了 	M
本报 连续 报道 了 有关 黑熊 事件 和 野生 动物 保护 问题 	M
本 案 系 采用 规格 及 价格 合并 计分 的 方式 进行 	T
若 教授 都 很 有 良知 	T
不知 他 又 在 搞 什么 名堂 	M
有时 连 广东省 以外 的 中国人 也 觉 古怪 	T
则 是 民国 七十二年 向 香港 收藏家 所 购得 	T
钱薇娟 在 国内 有 了 知名度 	T
能 打败 八百万 国民党 反动派 大军 	M